day;date;time;Spolu_prejazdy;Smer_MostSNP;Smer_Stary_most
streda;1.1.2020;0:00;15;2;13
streda;1.1.2020;1:00;1;1;0
streda;1.1.2020;2:00;1;1;0
streda;1.1.2020;3:00;1;1;0
streda;1.1.2020;4:00;0;0;0
streda;1.1.2020;5:00;2;0;2
streda;1.1.2020;6:00;0;0;0
streda;1.1.2020;7:00;0;0;0
streda;1.1.2020;8:00;0;0;0
streda;1.1.2020;9:00;7;7;0
streda;1.1.2020;10:00;23;15;8
streda;1.1.2020;11:00;36;21;15
streda;1.1.2020;12:00;45;29;16
streda;1.1.2020;13:00;55;28;27
streda;1.1.2020;14:00;82;55;27
streda;1.1.2020;15:00;48;16;32
streda;1.1.2020;16:00;27;8;19
streda;1.1.2020;17:00;6;3;3
streda;1.1.2020;18:00;3;2;1
streda;1.1.2020;19:00;4;1;3
streda;1.1.2020;20:00;2;2;0
streda;1.1.2020;21:00;1;1;0
streda;1.1.2020;22:00;2;2;0
streda;1.1.2020;23:00;1;0;1
štvrtok;2.1.2020;0:00;0;0;0
štvrtok;2.1.2020;1:00;0;0;0
štvrtok;2.1.2020;2:00;0;0;0
štvrtok;2.1.2020;3:00;0;0;0
štvrtok;2.1.2020;4:00;0;0;0
štvrtok;2.1.2020;5:00;0;0;0
štvrtok;2.1.2020;6:00;2;2;0
štvrtok;2.1.2020;7:00;7;3;4
štvrtok;2.1.2020;8:00;14;3;11
štvrtok;2.1.2020;9:00;8;3;5
štvrtok;2.1.2020;10:00;11;9;2
štvrtok;2.1.2020;11:00;17;11;6
štvrtok;2.1.2020;12:00;22;13;9
štvrtok;2.1.2020;13:00;33;22;11
štvrtok;2.1.2020;14:00;28;18;10
štvrtok;2.1.2020;15:00;29;13;16
štvrtok;2.1.2020;16:00;22;7;15
štvrtok;2.1.2020;17:00;20;11;9
štvrtok;2.1.2020;18:00;7;4;3
štvrtok;2.1.2020;19:00;6;5;1
štvrtok;2.1.2020;20:00;5;3;2
štvrtok;2.1.2020;21:00;2;0;2
štvrtok;2.1.2020;22:00;0;0;0
štvrtok;2.1.2020;23:00;3;3;0
piatok;3.1.2020;0:00;1;0;1
piatok;3.1.2020;1:00;0;0;0
piatok;3.1.2020;2:00;0;0;0
piatok;3.1.2020;3:00;0;0;0
piatok;3.1.2020;4:00;0;0;0
piatok;3.1.2020;5:00;0;0;0
piatok;3.1.2020;6:00;2;2;0
piatok;3.1.2020;7:00;3;1;2
piatok;3.1.2020;8:00;7;2;5
piatok;3.1.2020;9:00;4;1;3
piatok;3.1.2020;10:00;2;1;1
piatok;3.1.2020;11:00;11;5;6
piatok;3.1.2020;12:00;8;6;2
piatok;3.1.2020;13:00;5;3;2
piatok;3.1.2020;14:00;6;4;2
piatok;3.1.2020;15:00;15;7;8
piatok;3.1.2020;16:00;13;6;7
piatok;3.1.2020;17:00;10;6;4
piatok;3.1.2020;18:00;7;7;0
piatok;3.1.2020;19:00;5;2;3
piatok;3.1.2020;20:00;6;4;2
piatok;3.1.2020;21:00;2;0;2
piatok;3.1.2020;22:00;1;0;1
piatok;3.1.2020;23:00;1;0;1
sobota;4.1.2020;0:00;2;0;2
sobota;4.1.2020;1:00;0;0;0
sobota;4.1.2020;2:00;0;0;0
sobota;4.1.2020;3:00;0;0;0
sobota;4.1.2020;4:00;0;0;0
sobota;4.1.2020;5:00;1;1;0
sobota;4.1.2020;6:00;0;0;0
sobota;4.1.2020;7:00;1;1;0
sobota;4.1.2020;8:00;3;0;3
sobota;4.1.2020;9:00;6;3;3
sobota;4.1.2020;10:00;7;6;1
sobota;4.1.2020;11:00;22;14;8
sobota;4.1.2020;12:00;20;11;9
sobota;4.1.2020;13:00;31;19;12
sobota;4.1.2020;14:00;24;13;11
sobota;4.1.2020;15:00;26;16;10
sobota;4.1.2020;16:00;12;4;8
sobota;4.1.2020;17:00;3;2;1
sobota;4.1.2020;18:00;7;4;3
sobota;4.1.2020;19:00;4;2;2
sobota;4.1.2020;20:00;1;0;1
sobota;4.1.2020;21:00;0;0;0
sobota;4.1.2020;22:00;3;3;0
sobota;4.1.2020;23:00;1;1;0
nede?a;5.1.2020;0:00;1;0;1
nede?a;5.1.2020;1:00;0;0;0
nede?a;5.1.2020;2:00;0;0;0
nede?a;5.1.2020;3:00;0;0;0
nede?a;5.1.2020;4:00;0;0;0
nede?a;5.1.2020;5:00;0;0;0
nede?a;5.1.2020;6:00;3;3;0
nede?a;5.1.2020;7:00;1;1;0
nede?a;5.1.2020;8:00;1;1;0
nede?a;5.1.2020;9:00;6;2;4
nede?a;5.1.2020;10:00;19;13;6
nede?a;5.1.2020;11:00;23;14;9
nede?a;5.1.2020;12:00;24;12;12
nede?a;5.1.2020;13:00;26;11;15
nede?a;5.1.2020;14:00;21;16;5
nede?a;5.1.2020;15:00;22;9;13
nede?a;5.1.2020;16:00;20;6;14
nede?a;5.1.2020;17:00;11;3;8
nede?a;5.1.2020;18:00;3;2;1
nede?a;5.1.2020;19:00;6;1;5
nede?a;5.1.2020;20:00;1;0;1
nede?a;5.1.2020;21:00;0;0;0
nede?a;5.1.2020;22:00;0;0;0
nede?a;5.1.2020;23:00;1;1;0
pondelok;6.1.2020;0:00;1;0;1
pondelok;6.1.2020;1:00;0;0;0
pondelok;6.1.2020;2:00;0;0;0
pondelok;6.1.2020;3:00;0;0;0
pondelok;6.1.2020;4:00;0;0;0
pondelok;6.1.2020;5:00;1;1;0
pondelok;6.1.2020;6:00;1;1;0
pondelok;6.1.2020;7:00;1;0;1
pondelok;6.1.2020;8:00;3;3;0
pondelok;6.1.2020;9:00;7;3;4
pondelok;6.1.2020;10:00;27;22;5
pondelok;6.1.2020;11:00;42;31;11
pondelok;6.1.2020;12:00;49;26;23
pondelok;6.1.2020;13:00;60;31;29
pondelok;6.1.2020;14:00;69;32;37
pondelok;6.1.2020;15:00;48;26;22
pondelok;6.1.2020;16:00;15;4;11
pondelok;6.1.2020;17:00;7;3;4
pondelok;6.1.2020;18:00;4;3;1
pondelok;6.1.2020;19:00;6;4;2
pondelok;6.1.2020;20:00;1;1;0
pondelok;6.1.2020;21:00;4;2;2
pondelok;6.1.2020;22:00;0;0;0
pondelok;6.1.2020;23:00;1;1;0
utorok;7.1.2020;0:00;1;0;1
utorok;7.1.2020;1:00;0;0;0
utorok;7.1.2020;2:00;0;0;0
utorok;7.1.2020;3:00;0;0;0
utorok;7.1.2020;4:00;0;0;0
utorok;7.1.2020;5:00;4;2;2
utorok;7.1.2020;6:00;3;1;2
utorok;7.1.2020;7:00;14;8;6
utorok;7.1.2020;8:00;20;7;13
utorok;7.1.2020;9:00;11;3;8
utorok;7.1.2020;10:00;3;3;0
utorok;7.1.2020;11:00;6;4;2
utorok;7.1.2020;12:00;7;6;1
utorok;7.1.2020;13:00;6;3;3
utorok;7.1.2020;14:00;19;12;7
utorok;7.1.2020;15:00;22;8;14
utorok;7.1.2020;16:00;26;11;15
utorok;7.1.2020;17:00;25;15;10
utorok;7.1.2020;18:00;17;9;8
utorok;7.1.2020;19:00;7;4;3
utorok;7.1.2020;20:00;1;1;0
utorok;7.1.2020;21:00;1;1;0
utorok;7.1.2020;22:00;0;0;0
utorok;7.1.2020;23:00;0;0;0
streda;8.1.2020;0:00;0;0;0
streda;8.1.2020;1:00;0;0;0
streda;8.1.2020;2:00;0;0;0
streda;8.1.2020;3:00;0;0;0
streda;8.1.2020;4:00;1;0;1
streda;8.1.2020;5:00;2;1;1
streda;8.1.2020;6:00;1;0;1
streda;8.1.2020;7:00;18;7;11
streda;8.1.2020;8:00;29;14;15
streda;8.1.2020;9:00;10;3;7
streda;8.1.2020;10:00;8;4;4
streda;8.1.2020;11:00;12;6;6
streda;8.1.2020;12:00;7;6;1
streda;8.1.2020;13:00;11;7;4
streda;8.1.2020;14:00;17;10;7
streda;8.1.2020;15:00;18;9;9
streda;8.1.2020;16:00;37;18;19
streda;8.1.2020;17:00;27;17;10
streda;8.1.2020;18:00;15;9;6
streda;8.1.2020;19:00;14;6;8
streda;8.1.2020;20:00;3;1;2
streda;8.1.2020;21:00;1;0;1
streda;8.1.2020;22:00;1;1;0
streda;8.1.2020;23:00;2;1;1
štvrtok;9.1.2020;0:00;0;0;0
štvrtok;9.1.2020;1:00;0;0;0
štvrtok;9.1.2020;2:00;0;0;0
štvrtok;9.1.2020;3:00;0;0;0
štvrtok;9.1.2020;4:00;0;0;0
štvrtok;9.1.2020;5:00;2;0;2
štvrtok;9.1.2020;6:00;2;1;1
štvrtok;9.1.2020;7:00;11;4;7
štvrtok;9.1.2020;8:00;26;8;18
štvrtok;9.1.2020;9:00;11;2;9
štvrtok;9.1.2020;10:00;8;6;2
štvrtok;9.1.2020;11:00;8;4;4
štvrtok;9.1.2020;12:00;5;3;2
štvrtok;9.1.2020;13:00;6;5;1
štvrtok;9.1.2020;14:00;6;5;1
štvrtok;9.1.2020;15:00;27;15;12
štvrtok;9.1.2020;16:00;25;12;13
štvrtok;9.1.2020;17:00;31;16;15
štvrtok;9.1.2020;18:00;13;13;0
štvrtok;9.1.2020;19:00;17;6;11
štvrtok;9.1.2020;20:00;11;6;5
štvrtok;9.1.2020;21:00;5;2;3
štvrtok;9.1.2020;22:00;1;1;0
štvrtok;9.1.2020;23:00;0;0;0
piatok;10.1.2020;0:00;0;0;0
piatok;10.1.2020;1:00;0;0;0
piatok;10.1.2020;2:00;0;0;0
piatok;10.1.2020;3:00;0;0;0
piatok;10.1.2020;4:00;0;0;0
piatok;10.1.2020;5:00;1;0;1
piatok;10.1.2020;6:00;5;3;2
piatok;10.1.2020;7:00;11;4;7
piatok;10.1.2020;8:00;16;4;12
piatok;10.1.2020;9:00;12;5;7
piatok;10.1.2020;10:00;7;4;3
piatok;10.1.2020;11:00;11;7;4
piatok;10.1.2020;12:00;5;2;3
piatok;10.1.2020;13:00;9;3;6
piatok;10.1.2020;14:00;14;10;4
piatok;10.1.2020;15:00;18;8;10
piatok;10.1.2020;16:00;25;13;12
piatok;10.1.2020;17:00;18;15;3
piatok;10.1.2020;18:00;13;6;7
piatok;10.1.2020;19:00;6;3;3
piatok;10.1.2020;20:00;3;2;1
piatok;10.1.2020;21:00;3;2;1
piatok;10.1.2020;22:00;2;1;1
piatok;10.1.2020;23:00;1;0;1
sobota;11.1.2020;0:00;1;1;0
sobota;11.1.2020;1:00;1;0;1
sobota;11.1.2020;2:00;0;0;0
sobota;11.1.2020;3:00;0;0;0
sobota;11.1.2020;4:00;0;0;0
sobota;11.1.2020;5:00;1;1;0
sobota;11.1.2020;6:00;2;1;1
sobota;11.1.2020;7:00;0;0;0
sobota;11.1.2020;8:00;4;2;2
sobota;11.1.2020;9:00;6;4;2
sobota;11.1.2020;10:00;30;24;6
sobota;11.1.2020;11:00;34;22;12
sobota;11.1.2020;12:00;63;42;21
sobota;11.1.2020;13:00;53;25;28
sobota;11.1.2020;14:00;70;36;34
sobota;11.1.2020;15:00;46;27;19
sobota;11.1.2020;16:00;27;9;18
sobota;11.1.2020;17:00;12;5;7
sobota;11.1.2020;18:00;13;9;4
sobota;11.1.2020;19:00;4;0;4
sobota;11.1.2020;20:00;4;0;4
sobota;11.1.2020;21:00;3;2;1
sobota;11.1.2020;22:00;1;1;0
sobota;11.1.2020;23:00;0;0;0
nede?a;12.1.2020;0:00;0;0;0
nede?a;12.1.2020;1:00;2;0;2
nede?a;12.1.2020;2:00;0;0;0
nede?a;12.1.2020;3:00;0;0;0
nede?a;12.1.2020;4:00;1;0;1
nede?a;12.1.2020;5:00;0;0;0
nede?a;12.1.2020;6:00;2;0;2
nede?a;12.1.2020;7:00;0;0;0
nede?a;12.1.2020;8:00;5;3;2
nede?a;12.1.2020;9:00;13;6;7
nede?a;12.1.2020;10:00;53;34;19
nede?a;12.1.2020;11:00;41;22;19
nede?a;12.1.2020;12:00;60;38;22
nede?a;12.1.2020;13:00;54;35;19
nede?a;12.1.2020;14:00;55;27;28
nede?a;12.1.2020;15:00;49;17;32
nede?a;12.1.2020;16:00;19;11;8
nede?a;12.1.2020;17:00;10;7;3
nede?a;12.1.2020;18:00;6;3;3
nede?a;12.1.2020;19:00;4;1;3
nede?a;12.1.2020;20:00;0;0;0
nede?a;12.1.2020;21:00;1;1;0
nede?a;12.1.2020;22:00;1;1;0
nede?a;12.1.2020;23:00;3;0;3
pondelok;13.1.2020;0:00;0;0;0
pondelok;13.1.2020;1:00;0;0;0
pondelok;13.1.2020;2:00;0;0;0
pondelok;13.1.2020;3:00;0;0;0
pondelok;13.1.2020;4:00;1;0;1
pondelok;13.1.2020;5:00;2;1;1
pondelok;13.1.2020;6:00;1;0;1
pondelok;13.1.2020;7:00;11;7;4
pondelok;13.1.2020;8:00;35;14;21
pondelok;13.1.2020;9:00;9;3;6
pondelok;13.1.2020;10:00;8;5;3
pondelok;13.1.2020;11:00;8;5;3
pondelok;13.1.2020;12:00;9;6;3
pondelok;13.1.2020;13:00;9;3;6
pondelok;13.1.2020;14:00;11;5;6
pondelok;13.1.2020;15:00;14;7;7
pondelok;13.1.2020;16:00;24;11;13
pondelok;13.1.2020;17:00;29;13;16
pondelok;13.1.2020;18:00;16;10;6
pondelok;13.1.2020;19:00;15;10;5
pondelok;13.1.2020;20:00;5;2;3
pondelok;13.1.2020;21:00;3;3;0
pondelok;13.1.2020;22:00;2;2;0
pondelok;13.1.2020;23:00;0;0;0
utorok;14.1.2020;0:00;0;0;0
utorok;14.1.2020;1:00;0;0;0
utorok;14.1.2020;2:00;0;0;0
utorok;14.1.2020;3:00;0;0;0
utorok;14.1.2020;4:00;0;0;0
utorok;14.1.2020;5:00;1;0;1
utorok;14.1.2020;6:00;4;3;1
utorok;14.1.2020;7:00;6;2;4
utorok;14.1.2020;8:00;17;8;9
utorok;14.1.2020;9:00;4;1;3
utorok;14.1.2020;10:00;2;1;1
utorok;14.1.2020;11:00;1;1;0
utorok;14.1.2020;12:00;5;1;4
utorok;14.1.2020;13:00;3;1;2
utorok;14.1.2020;14:00;2;1;1
utorok;14.1.2020;15:00;5;1;4
utorok;14.1.2020;16:00;13;4;9
utorok;14.1.2020;17:00;10;5;5
utorok;14.1.2020;18:00;3;1;2
utorok;14.1.2020;19:00;3;1;2
utorok;14.1.2020;20:00;3;2;1
utorok;14.1.2020;21:00;1;0;1
utorok;14.1.2020;22:00;2;1;1
utorok;14.1.2020;23:00;0;0;0
streda;15.1.2020;0:00;0;0;0
streda;15.1.2020;1:00;0;0;0
streda;15.1.2020;2:00;0;0;0
streda;15.1.2020;3:00;0;0;0
streda;15.1.2020;4:00;0;0;0
streda;15.1.2020;5:00;1;0;1
streda;15.1.2020;6:00;2;2;0
streda;15.1.2020;7:00;8;3;5
streda;15.1.2020;8:00;8;3;5
streda;15.1.2020;9:00;5;1;4
streda;15.1.2020;10:00;6;4;2
streda;15.1.2020;11:00;1;0;1
streda;15.1.2020;12:00;5;2;3
streda;15.1.2020;13:00;3;2;1
streda;15.1.2020;14:00;6;4;2
streda;15.1.2020;15:00;9;4;5
streda;15.1.2020;16:00;17;7;10
streda;15.1.2020;17:00;14;6;8
streda;15.1.2020;18:00;9;5;4
streda;15.1.2020;19:00;7;2;5
streda;15.1.2020;20:00;3;1;2
streda;15.1.2020;21:00;1;1;0
streda;15.1.2020;22:00;0;0;0
streda;15.1.2020;23:00;3;2;1
štvrtok;16.1.2020;0:00;1;0;1
štvrtok;16.1.2020;1:00;0;0;0
štvrtok;16.1.2020;2:00;1;1;0
štvrtok;16.1.2020;3:00;0;0;0
štvrtok;16.1.2020;4:00;0;0;0
štvrtok;16.1.2020;5:00;1;1;0
štvrtok;16.1.2020;6:00;4;2;2
štvrtok;16.1.2020;7:00;11;3;8
štvrtok;16.1.2020;8:00;18;7;11
štvrtok;16.1.2020;9:00;5;2;3
štvrtok;16.1.2020;10:00;10;5;5
štvrtok;16.1.2020;11:00;14;6;8
štvrtok;16.1.2020;12:00;5;3;2
štvrtok;16.1.2020;13:00;6;3;3
štvrtok;16.1.2020;14:00;13;7;6
štvrtok;16.1.2020;15:00;12;5;7
štvrtok;16.1.2020;16:00;29;10;19
štvrtok;16.1.2020;17:00;29;20;9
štvrtok;16.1.2020;18:00;13;8;5
štvrtok;16.1.2020;19:00;8;6;2
štvrtok;16.1.2020;20:00;5;1;4
štvrtok;16.1.2020;21:00;1;1;0
štvrtok;16.1.2020;22:00;4;1;3
štvrtok;16.1.2020;23:00;0;0;0
piatok;17.1.2020;0:00;0;0;0
piatok;17.1.2020;1:00;0;0;0
piatok;17.1.2020;2:00;0;0;0
piatok;17.1.2020;3:00;0;0;0
piatok;17.1.2020;4:00;0;0;0
piatok;17.1.2020;5:00;1;0;1
piatok;17.1.2020;6:00;1;1;0
piatok;17.1.2020;7:00;9;4;5
piatok;17.1.2020;8:00;15;5;10
piatok;17.1.2020;9:00;9;3;6
piatok;17.1.2020;10:00;9;4;5
piatok;17.1.2020;11:00;6;1;5
piatok;17.1.2020;12:00;7;4;3
piatok;17.1.2020;13:00;9;0;9
piatok;17.1.2020;14:00;5;4;1
piatok;17.1.2020;15:00;12;6;6
piatok;17.1.2020;16:00;21;7;14
piatok;17.1.2020;17:00;12;9;3
piatok;17.1.2020;18:00;7;5;2
piatok;17.1.2020;19:00;3;1;2
piatok;17.1.2020;20:00;4;2;2
piatok;17.1.2020;21:00;19;0;19
piatok;17.1.2020;22:00;2;0;2
piatok;17.1.2020;23:00;1;1;0
sobota;18.1.2020;0:00;0;0;0
sobota;18.1.2020;1:00;0;0;0
sobota;18.1.2020;2:00;0;0;0
sobota;18.1.2020;3:00;0;0;0
sobota;18.1.2020;4:00;0;0;0
sobota;18.1.2020;5:00;0;0;0
sobota;18.1.2020;6:00;0;0;0
sobota;18.1.2020;7:00;2;1;1
sobota;18.1.2020;8:00;0;0;0
sobota;18.1.2020;9:00;3;2;1
sobota;18.1.2020;10:00;6;4;2
sobota;18.1.2020;11:00;15;11;4
sobota;18.1.2020;12:00;8;5;3
sobota;18.1.2020;13:00;7;3;4
sobota;18.1.2020;14:00;9;2;7
sobota;18.1.2020;15:00;5;3;2
sobota;18.1.2020;16:00;6;3;3
sobota;18.1.2020;17:00;5;1;4
sobota;18.1.2020;18:00;4;0;4
sobota;18.1.2020;19:00;3;0;3
sobota;18.1.2020;20:00;0;0;0
sobota;18.1.2020;21:00;5;1;4
sobota;18.1.2020;22:00;0;0;0
sobota;18.1.2020;23:00;1;1;0
nede?a;19.1.2020;0:00;1;0;1
nede?a;19.1.2020;1:00;1;0;1
nede?a;19.1.2020;2:00;0;0;0
nede?a;19.1.2020;3:00;0;0;0
nede?a;19.1.2020;4:00;0;0;0
nede?a;19.1.2020;5:00;0;0;0
nede?a;19.1.2020;6:00;0;0;0
nede?a;19.1.2020;7:00;3;1;2
nede?a;19.1.2020;8:00;4;2;2
nede?a;19.1.2020;9:00;3;2;1
nede?a;19.1.2020;10:00;3;2;1
nede?a;19.1.2020;11:00;4;3;1
nede?a;19.1.2020;12:00;3;1;2
nede?a;19.1.2020;13:00;12;6;6
nede?a;19.1.2020;14:00;3;2;1
nede?a;19.1.2020;15:00;5;2;3
nede?a;19.1.2020;16:00;5;1;4
nede?a;19.1.2020;17:00;2;0;2
nede?a;19.1.2020;18:00;0;0;0
nede?a;19.1.2020;19:00;2;0;2
nede?a;19.1.2020;20:00;2;2;0
nede?a;19.1.2020;21:00;0;0;0
nede?a;19.1.2020;22:00;1;1;0
nede?a;19.1.2020;23:00;0;0;0
pondelok;20.1.2020;0:00;1;0;1
pondelok;20.1.2020;1:00;0;0;0
pondelok;20.1.2020;2:00;0;0;0
pondelok;20.1.2020;3:00;0;0;0
pondelok;20.1.2020;4:00;1;1;0
pondelok;20.1.2020;5:00;1;0;1
pondelok;20.1.2020;6:00;5;1;4
pondelok;20.1.2020;7:00;15;7;8
pondelok;20.1.2020;8:00;13;7;6
pondelok;20.1.2020;9:00;6;4;2
pondelok;20.1.2020;10:00;9;7;2
pondelok;20.1.2020;11:00;9;5;4
pondelok;20.1.2020;12:00;6;3;3
pondelok;20.1.2020;13:00;17;7;10
pondelok;20.1.2020;14:00;14;7;7
pondelok;20.1.2020;15:00;25;13;12
pondelok;20.1.2020;16:00;35;15;20
pondelok;20.1.2020;17:00;21;10;11
pondelok;20.1.2020;18:00;14;8;6
pondelok;20.1.2020;19:00;12;5;7
pondelok;20.1.2020;20:00;6;4;2
pondelok;20.1.2020;21:00;3;1;2
pondelok;20.1.2020;22:00;0;0;0
pondelok;20.1.2020;23:00;0;0;0
utorok;21.1.2020;0:00;0;0;0
utorok;21.1.2020;1:00;1;0;1
utorok;21.1.2020;2:00;0;0;0
utorok;21.1.2020;3:00;0;0;0
utorok;21.1.2020;4:00;0;0;0
utorok;21.1.2020;5:00;2;1;1
utorok;21.1.2020;6:00;4;1;3
utorok;21.1.2020;7:00;12;5;7
utorok;21.1.2020;8:00;16;8;8
utorok;21.1.2020;9:00;14;5;9
utorok;21.1.2020;10:00;4;2;2
utorok;21.1.2020;11:00;6;3;3
utorok;21.1.2020;12:00;7;6;1
utorok;21.1.2020;13:00;7;2;5
utorok;21.1.2020;14:00;6;2;4
utorok;21.1.2020;15:00;11;4;7
utorok;21.1.2020;16:00;23;8;15
utorok;21.1.2020;17:00;26;17;9
utorok;21.1.2020;18:00;9;7;2
utorok;21.1.2020;19:00;7;4;3
utorok;21.1.2020;20:00;3;2;1
utorok;21.1.2020;21:00;3;2;1
utorok;21.1.2020;22:00;2;2;0
utorok;21.1.2020;23:00;0;0;0
streda;22.1.2020;0:00;1;1;0
streda;22.1.2020;1:00;0;0;0
streda;22.1.2020;2:00;0;0;0
streda;22.1.2020;3:00;0;0;0
streda;22.1.2020;4:00;0;0;0
streda;22.1.2020;5:00;1;0;1
streda;22.1.2020;6:00;1;0;1
streda;22.1.2020;7:00;12;8;4
streda;22.1.2020;8:00;13;5;8
streda;22.1.2020;9:00;11;4;7
streda;22.1.2020;10:00;4;2;2
streda;22.1.2020;11:00;9;3;6
streda;22.1.2020;12:00;5;3;2
streda;22.1.2020;13:00;4;2;2
streda;22.1.2020;14:00;12;6;6
streda;22.1.2020;15:00;18;12;6
streda;22.1.2020;16:00;23;11;12
streda;22.1.2020;17:00;15;6;9
streda;22.1.2020;18:00;10;7;3
streda;22.1.2020;19:00;13;5;8
streda;22.1.2020;20:00;5;2;3
streda;22.1.2020;21:00;2;0;2
streda;22.1.2020;22:00;3;2;1
streda;22.1.2020;23:00;2;2;0
štvrtok;23.1.2020;0:00;1;0;1
štvrtok;23.1.2020;1:00;0;0;0
štvrtok;23.1.2020;2:00;0;0;0
štvrtok;23.1.2020;3:00;0;0;0
štvrtok;23.1.2020;4:00;2;1;1
štvrtok;23.1.2020;5:00;0;0;0
štvrtok;23.1.2020;6:00;2;1;1
štvrtok;23.1.2020;7:00;9;7;2
štvrtok;23.1.2020;8:00;30;9;21
štvrtok;23.1.2020;9:00;10;2;8
štvrtok;23.1.2020;10:00;8;4;4
štvrtok;23.1.2020;11:00;17;8;9
štvrtok;23.1.2020;12:00;17;8;9
štvrtok;23.1.2020;13:00;20;8;12
štvrtok;23.1.2020;14:00;31;17;14
štvrtok;23.1.2020;15:00;45;20;25
štvrtok;23.1.2020;16:00;26;10;16
štvrtok;23.1.2020;17:00;35;15;20
štvrtok;23.1.2020;18:00;29;14;15
štvrtok;23.1.2020;19:00;14;6;8
štvrtok;23.1.2020;20:00;5;3;2
štvrtok;23.1.2020;21:00;7;1;6
štvrtok;23.1.2020;22:00;4;4;0
štvrtok;23.1.2020;23:00;1;0;1
piatok;24.1.2020;0:00;2;0;2
piatok;24.1.2020;1:00;0;0;0
piatok;24.1.2020;2:00;0;0;0
piatok;24.1.2020;3:00;0;0;0
piatok;24.1.2020;4:00;0;0;0
piatok;24.1.2020;5:00;4;1;3
piatok;24.1.2020;6:00;4;2;2
piatok;24.1.2020;7:00;13;4;9
piatok;24.1.2020;8:00;8;1;7
piatok;24.1.2020;9:00;6;2;4
piatok;24.1.2020;10:00;9;3;6
piatok;24.1.2020;11:00;7;2;5
piatok;24.1.2020;12:00;14;5;9
piatok;24.1.2020;13:00;14;5;9
piatok;24.1.2020;14:00;10;4;6
piatok;24.1.2020;15:00;15;7;8
piatok;24.1.2020;16:00;18;10;8
piatok;24.1.2020;17:00;16;7;9
piatok;24.1.2020;18:00;18;9;9
piatok;24.1.2020;19:00;8;2;6
piatok;24.1.2020;20:00;3;1;2
piatok;24.1.2020;21:00;0;0;0
piatok;24.1.2020;22:00;1;1;0
piatok;24.1.2020;23:00;2;0;2
sobota;25.1.2020;0:00;0;0;0
sobota;25.1.2020;1:00;2;1;1
sobota;25.1.2020;2:00;0;0;0
sobota;25.1.2020;3:00;0;0;0
sobota;25.1.2020;4:00;0;0;0
sobota;25.1.2020;5:00;0;0;0
sobota;25.1.2020;6:00;2;2;0
sobota;25.1.2020;7:00;1;1;0
sobota;25.1.2020;8:00;2;2;0
sobota;25.1.2020;9:00;1;1;0
sobota;25.1.2020;10:00;5;1;4
sobota;25.1.2020;11:00;10;6;4
sobota;25.1.2020;12:00;8;6;2
sobota;25.1.2020;13:00;11;7;4
sobota;25.1.2020;14:00;17;6;11
sobota;25.1.2020;15:00;18;10;8
sobota;25.1.2020;16:00;8;3;5
sobota;25.1.2020;17:00;8;3;5
sobota;25.1.2020;18:00;5;1;4
sobota;25.1.2020;19:00;8;1;7
sobota;25.1.2020;20:00;4;1;3
sobota;25.1.2020;21:00;3;2;1
sobota;25.1.2020;22:00;0;0;0
sobota;25.1.2020;23:00;2;0;2
nede?a;26.1.2020;0:00;1;0;1
nede?a;26.1.2020;1:00;0;0;0
nede?a;26.1.2020;2:00;0;0;0
nede?a;26.1.2020;3:00;0;0;0
nede?a;26.1.2020;4:00;0;0;0
nede?a;26.1.2020;5:00;0;0;0
nede?a;26.1.2020;6:00;0;0;0
nede?a;26.1.2020;7:00;0;0;0
nede?a;26.1.2020;8:00;3;2;1
nede?a;26.1.2020;9:00;8;7;1
nede?a;26.1.2020;10:00;8;5;3
nede?a;26.1.2020;11:00;9;4;5
nede?a;26.1.2020;12:00;13;4;9
nede?a;26.1.2020;13:00;14;5;9
nede?a;26.1.2020;14:00;17;8;9
nede?a;26.1.2020;15:00;7;3;4
nede?a;26.1.2020;16:00;13;3;10
nede?a;26.1.2020;17:00;8;0;8
nede?a;26.1.2020;18:00;7;3;4
nede?a;26.1.2020;19:00;5;1;4
nede?a;26.1.2020;20:00;10;2;8
nede?a;26.1.2020;21:00;13;2;11
nede?a;26.1.2020;22:00;4;1;3
nede?a;26.1.2020;23:00;2;1;1
pondelok;27.1.2020;0:00;1;0;1
pondelok;27.1.2020;1:00;0;0;0
pondelok;27.1.2020;2:00;0;0;0
pondelok;27.1.2020;3:00;0;0;0
pondelok;27.1.2020;4:00;1;1;0
pondelok;27.1.2020;5:00;3;1;2
pondelok;27.1.2020;6:00;2;1;1
pondelok;27.1.2020;7:00;12;6;6
pondelok;27.1.2020;8:00;23;9;14
pondelok;27.1.2020;9:00;7;1;6
pondelok;27.1.2020;10:00;5;3;2
pondelok;27.1.2020;11:00;8;6;2
pondelok;27.1.2020;12:00;10;4;6
pondelok;27.1.2020;13:00;8;4;4
pondelok;27.1.2020;14:00;5;4;1
pondelok;27.1.2020;15:00;17;7;10
pondelok;27.1.2020;16:00;24;12;12
pondelok;27.1.2020;17:00;19;10;9
pondelok;27.1.2020;18:00;10;6;4
pondelok;27.1.2020;19:00;8;5;3
pondelok;27.1.2020;20:00;4;1;3
pondelok;27.1.2020;21:00;3;1;2
pondelok;27.1.2020;22:00;1;0;1
pondelok;27.1.2020;23:00;0;0;0
utorok;28.1.2020;0:00;0;0;0
utorok;28.1.2020;1:00;1;0;1
utorok;28.1.2020;2:00;0;0;0
utorok;28.1.2020;3:00;0;0;0
utorok;28.1.2020;4:00;1;1;0
utorok;28.1.2020;5:00;1;0;1
utorok;28.1.2020;6:00;1;0;1
utorok;28.1.2020;7:00;4;2;2
utorok;28.1.2020;8:00;14;7;7
utorok;28.1.2020;9:00;8;3;5
utorok;28.1.2020;10:00;4;3;1
utorok;28.1.2020;11:00;1;0;1
utorok;28.1.2020;12:00;5;3;2
utorok;28.1.2020;13:00;4;3;1
utorok;28.1.2020;14:00;4;2;2
utorok;28.1.2020;15:00;7;2;5
utorok;28.1.2020;16:00;9;5;4
utorok;28.1.2020;17:00;9;4;5
utorok;28.1.2020;18:00;10;5;5
utorok;28.1.2020;19:00;5;2;3
utorok;28.1.2020;20:00;6;2;4
utorok;28.1.2020;21:00;2;1;1
utorok;28.1.2020;22:00;3;1;2
utorok;28.1.2020;23:00;1;0;1
streda;29.1.2020;0:00;0;0;0
streda;29.1.2020;1:00;0;0;0
streda;29.1.2020;2:00;1;0;1
streda;29.1.2020;3:00;0;0;0
streda;29.1.2020;4:00;1;1;0
streda;29.1.2020;5:00;1;0;1
streda;29.1.2020;6:00;3;2;1
streda;29.1.2020;7:00;8;4;4
streda;29.1.2020;8:00;10;4;6
streda;29.1.2020;9:00;41;2;39
streda;29.1.2020;10:00;43;2;41
streda;29.1.2020;11:00;6;1;5
streda;29.1.2020;12:00;1;1;0
streda;29.1.2020;13:00;4;2;2
streda;29.1.2020;14:00;4;3;1
streda;29.1.2020;15:00;5;2;3
streda;29.1.2020;16:00;15;8;7
streda;29.1.2020;17:00;28;15;13
streda;29.1.2020;18:00;10;5;5
streda;29.1.2020;19:00;9;4;5
streda;29.1.2020;20:00;7;4;3
streda;29.1.2020;21:00;2;1;1
streda;29.1.2020;22:00;1;0;1
streda;29.1.2020;23:00;2;2;0
štvrtok;30.1.2020;0:00;0;0;0
štvrtok;30.1.2020;1:00;0;0;0
štvrtok;30.1.2020;2:00;0;0;0
štvrtok;30.1.2020;3:00;2;2;0
štvrtok;30.1.2020;4:00;0;0;0
štvrtok;30.1.2020;5:00;1;1;0
štvrtok;30.1.2020;6:00;1;0;1
štvrtok;30.1.2020;7:00;8;3;5
štvrtok;30.1.2020;8:00;15;3;12
štvrtok;30.1.2020;9:00;16;9;7
štvrtok;30.1.2020;10:00;8;3;5
štvrtok;30.1.2020;11:00;16;6;10
štvrtok;30.1.2020;12:00;8;4;4
štvrtok;30.1.2020;13:00;11;4;7
štvrtok;30.1.2020;14:00;17;10;7
štvrtok;30.1.2020;15:00;26;10;16
štvrtok;30.1.2020;16:00;43;24;19
štvrtok;30.1.2020;17:00;36;16;20
štvrtok;30.1.2020;18:00;17;9;8
štvrtok;30.1.2020;19:00;10;7;3
štvrtok;30.1.2020;20:00;4;1;3
štvrtok;30.1.2020;21:00;7;4;3
štvrtok;30.1.2020;22:00;3;1;2
štvrtok;30.1.2020;23:00;3;2;1
piatok;31.1.2020;0:00;1;0;1
piatok;31.1.2020;1:00;0;0;0
piatok;31.1.2020;2:00;0;0;0
piatok;31.1.2020;3:00;0;0;0
piatok;31.1.2020;4:00;0;0;0
piatok;31.1.2020;5:00;0;0;0
piatok;31.1.2020;6:00;1;1;0
piatok;31.1.2020;7:00;12;3;9
piatok;31.1.2020;8:00;16;4;12
piatok;31.1.2020;9:00;6;3;3
piatok;31.1.2020;10:00;8;6;2
piatok;31.1.2020;11:00;13;4;9
piatok;31.1.2020;12:00;9;3;6
piatok;31.1.2020;13:00;20;9;11
piatok;31.1.2020;14:00;13;7;6
piatok;31.1.2020;15:00;25;13;12
piatok;31.1.2020;16:00;23;18;5
piatok;31.1.2020;17:00;29;19;10
piatok;31.1.2020;18:00;25;16;9
piatok;31.1.2020;19:00;11;4;7
piatok;31.1.2020;20:00;9;3;6
piatok;31.1.2020;21:00;4;3;1
piatok;31.1.2020;22:00;1;1;0
piatok;31.1.2020;23:00;3;1;2
sobota;1.2.2020;0:00;1;0;1
sobota;1.2.2020;1:00;0;0;0
sobota;1.2.2020;2:00;0;0;0
sobota;1.2.2020;3:00;0;0;0
sobota;1.2.2020;4:00;0;0;0
sobota;1.2.2020;5:00;0;0;0
sobota;1.2.2020;6:00;3;3;0
sobota;1.2.2020;7:00;6;2;4
sobota;1.2.2020;8:00;16;9;7
sobota;1.2.2020;9:00;40;34;6
sobota;1.2.2020;10:00;71;50;21
sobota;1.2.2020;11:00;108;73;35
sobota;1.2.2020;12:00;137;82;55
sobota;1.2.2020;13:00;178;106;72
sobota;1.2.2020;14:00;217;114;103
sobota;1.2.2020;15:00;154;77;77
sobota;1.2.2020;16:00;107;51;56
sobota;1.2.2020;17:00;54;24;30
sobota;1.2.2020;18:00;14;2;12
sobota;1.2.2020;19:00;25;3;22
sobota;1.2.2020;20:00;2;0;2
sobota;1.2.2020;21:00;21;0;21
sobota;1.2.2020;22:00;7;1;6
sobota;1.2.2020;23:00;9;9;0
nede?a;2.2.2020;0:00;1;0;1
nede?a;2.2.2020;1:00;0;0;0
nede?a;2.2.2020;2:00;2;0;2
nede?a;2.2.2020;3:00;0;0;0
nede?a;2.2.2020;4:00;0;0;0
nede?a;2.2.2020;5:00;0;0;0
nede?a;2.2.2020;6:00;0;0;0
nede?a;2.2.2020;7:00;5;4;1
nede?a;2.2.2020;8:00;11;5;6
nede?a;2.2.2020;9:00;21;13;8
nede?a;2.2.2020;10:00;48;33;15
nede?a;2.2.2020;11:00;72;40;32
nede?a;2.2.2020;12:00;76;46;30
nede?a;2.2.2020;13:00;95;45;50
nede?a;2.2.2020;14:00;70;31;39
nede?a;2.2.2020;15:00;50;19;31
nede?a;2.2.2020;16:00;24;18;6
nede?a;2.2.2020;17:00;10;4;6
nede?a;2.2.2020;18:00;3;2;1
nede?a;2.2.2020;19:00;1;0;1
nede?a;2.2.2020;20:00;2;2;0
nede?a;2.2.2020;21:00;1;1;0
nede?a;2.2.2020;22:00;0;0;0
nede?a;2.2.2020;23:00;0;0;0
pondelok;3.2.2020;0:00;0;0;0
pondelok;3.2.2020;1:00;0;0;0
pondelok;3.2.2020;2:00;0;0;0
pondelok;3.2.2020;3:00;0;0;0
pondelok;3.2.2020;4:00;0;0;0
pondelok;3.2.2020;5:00;1;0;1
pondelok;3.2.2020;6:00;1;0;1
pondelok;3.2.2020;7:00;4;2;2
pondelok;3.2.2020;8:00;4;3;1
pondelok;3.2.2020;9:00;2;1;1
pondelok;3.2.2020;10:00;0;0;0
pondelok;3.2.2020;11:00;2;1;1
pondelok;3.2.2020;12:00;3;2;1
pondelok;3.2.2020;13:00;2;1;1
pondelok;3.2.2020;14:00;10;6;4
pondelok;3.2.2020;15:00;9;5;4
pondelok;3.2.2020;16:00;11;5;6
pondelok;3.2.2020;17:00;13;9;4
pondelok;3.2.2020;18:00;6;4;2
pondelok;3.2.2020;19:00;3;2;1
pondelok;3.2.2020;20:00;4;3;1
pondelok;3.2.2020;21:00;1;1;0
pondelok;3.2.2020;22:00;0;0;0
pondelok;3.2.2020;23:00;4;1;3
utorok;4.2.2020;0:00;1;0;1
utorok;4.2.2020;1:00;0;0;0
utorok;4.2.2020;2:00;0;0;0
utorok;4.2.2020;3:00;0;0;0
utorok;4.2.2020;4:00;0;0;0
utorok;4.2.2020;5:00;1;0;1
utorok;4.2.2020;6:00;3;2;1
utorok;4.2.2020;7:00;6;2;4
utorok;4.2.2020;8:00;10;8;2
utorok;4.2.2020;9:00;7;1;6
utorok;4.2.2020;10:00;1;0;1
utorok;4.2.2020;11:00;2;1;1
utorok;4.2.2020;12:00;1;0;1
utorok;4.2.2020;13:00;2;0;2
utorok;4.2.2020;14:00;4;2;2
utorok;4.2.2020;15:00;6;3;3
utorok;4.2.2020;16:00;15;8;7
utorok;4.2.2020;17:00;20;11;9
utorok;4.2.2020;18:00;7;2;5
utorok;4.2.2020;19:00;3;1;2
utorok;4.2.2020;20:00;1;1;0
utorok;4.2.2020;21:00;3;2;1
utorok;4.2.2020;22:00;4;2;2
utorok;4.2.2020;23:00;1;0;1
streda;5.2.2020;0:00;0;0;0
streda;5.2.2020;1:00;0;0;0
streda;5.2.2020;2:00;0;0;0
streda;5.2.2020;3:00;0;0;0
streda;5.2.2020;4:00;0;0;0
streda;5.2.2020;5:00;0;0;0
streda;5.2.2020;6:00;3;2;1
streda;5.2.2020;7:00;9;5;4
streda;5.2.2020;8:00;23;10;13
streda;5.2.2020;9:00;11;2;9
streda;5.2.2020;10:00;3;2;1
streda;5.2.2020;11:00;7;3;4
streda;5.2.2020;12:00;10;3;7
streda;5.2.2020;13:00;5;1;4
streda;5.2.2020;14:00;7;2;5
streda;5.2.2020;15:00;15;7;8
streda;5.2.2020;16:00;28;10;18
streda;5.2.2020;17:00;28;12;16
streda;5.2.2020;18:00;14;7;7
streda;5.2.2020;19:00;5;3;2
streda;5.2.2020;20:00;8;2;6
streda;5.2.2020;21:00;4;0;4
streda;5.2.2020;22:00;4;2;2
streda;5.2.2020;23:00;1;1;0
štvrtok;6.2.2020;0:00;3;2;1
štvrtok;6.2.2020;1:00;0;0;0
štvrtok;6.2.2020;2:00;0;0;0
štvrtok;6.2.2020;3:00;0;0;0
štvrtok;6.2.2020;4:00;0;0;0
štvrtok;6.2.2020;5:00;1;0;1
štvrtok;6.2.2020;6:00;5;4;1
štvrtok;6.2.2020;7:00;17;7;10
štvrtok;6.2.2020;8:00;22;8;14
štvrtok;6.2.2020;9:00;9;3;6
štvrtok;6.2.2020;10:00;14;9;5
štvrtok;6.2.2020;11:00;10;5;5
štvrtok;6.2.2020;12:00;7;3;4
štvrtok;6.2.2020;13:00;6;4;2
štvrtok;6.2.2020;14:00;18;9;9
štvrtok;6.2.2020;15:00;20;11;9
štvrtok;6.2.2020;16:00;34;18;16
štvrtok;6.2.2020;17:00;23;14;9
štvrtok;6.2.2020;18:00;20;13;7
štvrtok;6.2.2020;19:00;8;5;3
štvrtok;6.2.2020;20:00;3;2;1
štvrtok;6.2.2020;21:00;2;0;2
štvrtok;6.2.2020;22:00;3;3;0
štvrtok;6.2.2020;23:00;0;0;0
piatok;7.2.2020;0:00;0;0;0
piatok;7.2.2020;1:00;0;0;0
piatok;7.2.2020;2:00;0;0;0
piatok;7.2.2020;3:00;0;0;0
piatok;7.2.2020;4:00;1;0;1
piatok;7.2.2020;5:00;1;0;1
piatok;7.2.2020;6:00;3;3;0
piatok;7.2.2020;7:00;10;3;7
piatok;7.2.2020;8:00;14;5;9
piatok;7.2.2020;9:00;17;8;9
piatok;7.2.2020;10:00;7;2;5
piatok;7.2.2020;11:00;6;2;4
piatok;7.2.2020;12:00;8;7;1
piatok;7.2.2020;13:00;13;8;5
piatok;7.2.2020;14:00;21;13;8
piatok;7.2.2020;15:00;36;19;17
piatok;7.2.2020;16:00;54;25;29
piatok;7.2.2020;17:00;26;17;9
piatok;7.2.2020;18:00;11;8;3
piatok;7.2.2020;19:00;11;9;2
piatok;7.2.2020;20:00;4;2;2
piatok;7.2.2020;21:00;7;4;3
piatok;7.2.2020;22:00;2;2;0
piatok;7.2.2020;23:00;2;2;0
sobota;8.2.2020;0:00;2;0;2
sobota;8.2.2020;1:00;0;0;0
sobota;8.2.2020;2:00;0;0;0
sobota;8.2.2020;3:00;0;0;0
sobota;8.2.2020;4:00;0;0;0
sobota;8.2.2020;5:00;0;0;0
sobota;8.2.2020;6:00;1;1;0
sobota;8.2.2020;7:00;1;1;0
sobota;8.2.2020;8:00;5;3;2
sobota;8.2.2020;9:00;9;7;2
sobota;8.2.2020;10:00;37;26;11
sobota;8.2.2020;11:00;40;22;18
sobota;8.2.2020;12:00;48;38;10
sobota;8.2.2020;13:00;48;23;25
sobota;8.2.2020;14:00;70;42;28
sobota;8.2.2020;15:00;65;38;27
sobota;8.2.2020;16:00;37;13;24
sobota;8.2.2020;17:00;31;5;26
sobota;8.2.2020;18:00;9;3;6
sobota;8.2.2020;19:00;7;2;5
sobota;8.2.2020;20:00;2;1;1
sobota;8.2.2020;21:00;2;2;0
sobota;8.2.2020;22:00;4;1;3
sobota;8.2.2020;23:00;0;0;0
nede?a;9.2.2020;0:00;2;2;0
nede?a;9.2.2020;1:00;2;1;1
nede?a;9.2.2020;2:00;1;1;0
nede?a;9.2.2020;3:00;0;0;0
nede?a;9.2.2020;4:00;0;0;0
nede?a;9.2.2020;5:00;0;0;0
nede?a;9.2.2020;6:00;2;1;1
nede?a;9.2.2020;7:00;2;1;1
nede?a;9.2.2020;8:00;2;2;0
nede?a;9.2.2020;9:00;4;3;1
nede?a;9.2.2020;10:00;26;17;9
nede?a;9.2.2020;11:00;32;24;8
nede?a;9.2.2020;12:00;61;32;29
nede?a;9.2.2020;13:00;77;54;23
nede?a;9.2.2020;14:00;91;49;42
nede?a;9.2.2020;15:00;80;43;37
nede?a;9.2.2020;16:00;42;19;23
nede?a;9.2.2020;17:00;13;7;6
nede?a;9.2.2020;18:00;9;3;6
nede?a;9.2.2020;19:00;3;2;1
nede?a;9.2.2020;20:00;4;3;1
nede?a;9.2.2020;21:00;2;2;0
nede?a;9.2.2020;22:00;3;3;0
nede?a;9.2.2020;23:00;4;1;3
pondelok;10.2.2020;0:00;0;0;0
pondelok;10.2.2020;1:00;0;0;0
pondelok;10.2.2020;2:00;0;0;0
pondelok;10.2.2020;3:00;0;0;0
pondelok;10.2.2020;4:00;0;0;0
pondelok;10.2.2020;5:00;2;0;2
pondelok;10.2.2020;6:00;3;1;2
pondelok;10.2.2020;7:00;13;7;6
pondelok;10.2.2020;8:00;26;13;13
pondelok;10.2.2020;9:00;8;3;5
pondelok;10.2.2020;10:00;4;3;1
pondelok;10.2.2020;11:00;11;5;6
pondelok;10.2.2020;12:00;7;0;7
pondelok;10.2.2020;13:00;1;0;1
pondelok;10.2.2020;14:00;4;4;0
pondelok;10.2.2020;15:00;7;6;1
pondelok;10.2.2020;16:00;25;12;13
pondelok;10.2.2020;17:00;20;10;10
pondelok;10.2.2020;18:00;7;3;4
pondelok;10.2.2020;19:00;3;3;0
pondelok;10.2.2020;20:00;4;3;1
pondelok;10.2.2020;21:00;3;2;1
pondelok;10.2.2020;22:00;2;1;1
pondelok;10.2.2020;23:00;0;0;0
utorok;11.2.2020;0:00;0;0;0
utorok;11.2.2020;1:00;0;0;0
utorok;11.2.2020;2:00;0;0;0
utorok;11.2.2020;3:00;0;0;0
utorok;11.2.2020;4:00;0;0;0
utorok;11.2.2020;5:00;0;0;0
utorok;11.2.2020;6:00;3;1;2
utorok;11.2.2020;7:00;10;5;5
utorok;11.2.2020;8:00;12;7;5
utorok;11.2.2020;9:00;3;2;1
utorok;11.2.2020;10:00;2;0;2
utorok;11.2.2020;11:00;5;2;3
utorok;11.2.2020;12:00;1;1;0
utorok;11.2.2020;13:00;6;3;3
utorok;11.2.2020;14:00;8;6;2
utorok;11.2.2020;15:00;8;4;4
utorok;11.2.2020;16:00;30;18;12
utorok;11.2.2020;17:00;21;14;7
utorok;11.2.2020;18:00;6;5;1
utorok;11.2.2020;19:00;8;4;4
utorok;11.2.2020;20:00;6;0;6
utorok;11.2.2020;21:00;3;0;3
utorok;11.2.2020;22:00;3;3;0
utorok;11.2.2020;23:00;6;1;5
streda;12.2.2020;0:00;1;0;1
streda;12.2.2020;1:00;0;0;0
streda;12.2.2020;2:00;0;0;0
streda;12.2.2020;3:00;0;0;0
streda;12.2.2020;4:00;0;0;0
streda;12.2.2020;5:00;1;0;1
streda;12.2.2020;6:00;2;0;2
streda;12.2.2020;7:00;15;9;6
streda;12.2.2020;8:00;20;6;14
streda;12.2.2020;9:00;10;1;9
streda;12.2.2020;10:00;9;6;3
streda;12.2.2020;11:00;9;6;3
streda;12.2.2020;12:00;9;3;6
streda;12.2.2020;13:00;7;3;4
streda;12.2.2020;14:00;17;10;7
streda;12.2.2020;15:00;21;13;8
streda;12.2.2020;16:00;24;11;13
streda;12.2.2020;17:00;27;18;9
streda;12.2.2020;18:00;15;8;7
streda;12.2.2020;19:00;10;8;2
streda;12.2.2020;20:00;7;3;4
streda;12.2.2020;21:00;3;2;1
streda;12.2.2020;22:00;3;1;2
streda;12.2.2020;23:00;4;3;1
štvrtok;13.2.2020;0:00;1;0;1
štvrtok;13.2.2020;1:00;0;0;0
štvrtok;13.2.2020;2:00;2;2;0
štvrtok;13.2.2020;3:00;0;0;0
štvrtok;13.2.2020;4:00;0;0;0
štvrtok;13.2.2020;5:00;1;0;1
štvrtok;13.2.2020;6:00;5;3;2
štvrtok;13.2.2020;7:00;14;5;9
štvrtok;13.2.2020;8:00;27;8;19
štvrtok;13.2.2020;9:00;16;8;8
štvrtok;13.2.2020;10:00;15;11;4
štvrtok;13.2.2020;11:00;18;7;11
štvrtok;13.2.2020;12:00;21;13;8
štvrtok;13.2.2020;13:00;31;14;17
štvrtok;13.2.2020;14:00;27;18;9
štvrtok;13.2.2020;15:00;43;20;23
štvrtok;13.2.2020;16:00;49;27;22
štvrtok;13.2.2020;17:00;31;16;15
štvrtok;13.2.2020;18:00;18;12;6
štvrtok;13.2.2020;19:00;19;11;8
štvrtok;13.2.2020;20:00;6;1;5
štvrtok;13.2.2020;21:00;2;0;2
štvrtok;13.2.2020;22:00;5;4;1
štvrtok;13.2.2020;23:00;2;1;1
piatok;14.2.2020;0:00;2;0;2
piatok;14.2.2020;1:00;0;0;0
piatok;14.2.2020;2:00;0;0;0
piatok;14.2.2020;3:00;0;0;0
piatok;14.2.2020;4:00;0;0;0
piatok;14.2.2020;5:00;1;0;1
piatok;14.2.2020;6:00;14;10;4
piatok;14.2.2020;7:00;17;5;12
piatok;14.2.2020;8:00;25;9;16
piatok;14.2.2020;9:00;11;7;4
piatok;14.2.2020;10:00;11;8;3
piatok;14.2.2020;11:00;9;5;4
piatok;14.2.2020;12:00;16;3;13
piatok;14.2.2020;13:00;11;7;4
piatok;14.2.2020;14:00;16;11;5
piatok;14.2.2020;15:00;25;11;14
piatok;14.2.2020;16:00;21;9;12
piatok;14.2.2020;17:00;22;14;8
piatok;14.2.2020;18:00;9;5;4
piatok;14.2.2020;19:00;15;6;9
piatok;14.2.2020;20:00;3;1;2
piatok;14.2.2020;21:00;1;1;0
piatok;14.2.2020;22:00;2;0;2
piatok;14.2.2020;23:00;3;3;0
sobota;15.2.2020;0:00;1;1;0
sobota;15.2.2020;1:00;0;0;0
sobota;15.2.2020;2:00;0;0;0
sobota;15.2.2020;3:00;0;0;0
sobota;15.2.2020;4:00;0;0;0
sobota;15.2.2020;5:00;0;0;0
sobota;15.2.2020;6:00;3;2;1
sobota;15.2.2020;7:00;5;3;2
sobota;15.2.2020;8:00;9;5;4
sobota;15.2.2020;9:00;22;16;6
sobota;15.2.2020;10:00;54;40;14
sobota;15.2.2020;11:00;105;74;31
sobota;15.2.2020;12:00;116;69;47
sobota;15.2.2020;13:00;121;67;54
sobota;15.2.2020;14:00;125;64;61
sobota;15.2.2020;15:00;131;72;59
sobota;15.2.2020;16:00;87;38;49
sobota;15.2.2020;17:00;34;15;19
sobota;15.2.2020;18:00;10;5;5
sobota;15.2.2020;19:00;3;2;1
sobota;15.2.2020;20:00;3;3;0
sobota;15.2.2020;21:00;3;3;0
sobota;15.2.2020;22:00;0;0;0
sobota;15.2.2020;23:00;1;1;0
nede?a;16.2.2020;0:00;1;0;1
nede?a;16.2.2020;1:00;1;1;0
nede?a;16.2.2020;2:00;0;0;0
nede?a;16.2.2020;3:00;0;0;0
nede?a;16.2.2020;4:00;0;0;0
nede?a;16.2.2020;5:00;0;0;0
nede?a;16.2.2020;6:00;2;2;0
nede?a;16.2.2020;7:00;3;2;1
nede?a;16.2.2020;8:00;7;3;4
nede?a;16.2.2020;9:00;31;26;5
nede?a;16.2.2020;10:00;42;34;8
nede?a;16.2.2020;11:00;60;41;19
nede?a;16.2.2020;12:00;61;35;26
nede?a;16.2.2020;13:00;81;46;35
nede?a;16.2.2020;14:00;74;41;33
nede?a;16.2.2020;15:00;82;41;41
nede?a;16.2.2020;16:00;51;18;33
nede?a;16.2.2020;17:00;23;14;9
nede?a;16.2.2020;18:00;5;3;2
nede?a;16.2.2020;19:00;6;3;3
nede?a;16.2.2020;20:00;3;0;3
nede?a;16.2.2020;21:00;0;0;0
nede?a;16.2.2020;22:00;2;1;1
nede?a;16.2.2020;23:00;2;1;1
pondelok;17.2.2020;0:00;0;0;0
pondelok;17.2.2020;1:00;0;0;0
pondelok;17.2.2020;2:00;1;1;0
pondelok;17.2.2020;3:00;0;0;0
pondelok;17.2.2020;4:00;0;0;0
pondelok;17.2.2020;5:00;3;0;3
pondelok;17.2.2020;6:00;7;2;5
pondelok;17.2.2020;7:00;18;11;7
pondelok;17.2.2020;8:00;26;8;18
pondelok;17.2.2020;9:00;26;10;16
pondelok;17.2.2020;10:00;13;10;3
pondelok;17.2.2020;11:00;18;11;7
pondelok;17.2.2020;12:00;27;20;7
pondelok;17.2.2020;13:00;39;24;15
pondelok;17.2.2020;14:00;48;24;24
pondelok;17.2.2020;15:00;50;31;19
pondelok;17.2.2020;16:00;69;41;28
pondelok;17.2.2020;17:00;64;35;29
pondelok;17.2.2020;18:00;26;14;12
pondelok;17.2.2020;19:00;13;7;6
pondelok;17.2.2020;20:00;7;5;2
pondelok;17.2.2020;21:00;6;6;0
pondelok;17.2.2020;22:00;3;0;3
pondelok;17.2.2020;23:00;2;1;1
utorok;18.2.2020;0:00;1;1;0
utorok;18.2.2020;1:00;0;0;0
utorok;18.2.2020;2:00;0;0;0
utorok;18.2.2020;3:00;0;0;0
utorok;18.2.2020;4:00;0;0;0
utorok;18.2.2020;5:00;3;1;2
utorok;18.2.2020;6:00;6;4;2
utorok;18.2.2020;7:00;9;4;5
utorok;18.2.2020;8:00;31;16;15
utorok;18.2.2020;9:00;15;9;6
utorok;18.2.2020;10:00;18;8;10
utorok;18.2.2020;11:00;17;9;8
utorok;18.2.2020;12:00;23;15;8
utorok;18.2.2020;13:00;16;8;8
utorok;18.2.2020;14:00;30;16;14
utorok;18.2.2020;15:00;30;18;12
utorok;18.2.2020;16:00;51;28;23
utorok;18.2.2020;17:00;36;19;17
utorok;18.2.2020;18:00;23;9;14
utorok;18.2.2020;19:00;7;5;2
utorok;18.2.2020;20:00;7;2;5
utorok;18.2.2020;21:00;4;1;3
utorok;18.2.2020;22:00;3;2;1
utorok;18.2.2020;23:00;1;1;0
streda;19.2.2020;0:00;1;0;1
streda;19.2.2020;1:00;0;0;0
streda;19.2.2020;2:00;0;0;0
streda;19.2.2020;3:00;0;0;0
streda;19.2.2020;4:00;0;0;0
streda;19.2.2020;5:00;5;3;2
streda;19.2.2020;6:00;8;4;4
streda;19.2.2020;7:00;16;10;6
streda;19.2.2020;8:00;16;8;8
streda;19.2.2020;9:00;16;7;9
streda;19.2.2020;10:00;10;4;6
streda;19.2.2020;11:00;11;4;7
streda;19.2.2020;12:00;15;7;8
streda;19.2.2020;13:00;8;3;5
streda;19.2.2020;14:00;15;9;6
streda;19.2.2020;15:00;28;12;16
streda;19.2.2020;16:00;22;9;13
streda;19.2.2020;17:00;11;6;5
streda;19.2.2020;18:00;5;2;3
streda;19.2.2020;19:00;4;0;4
streda;19.2.2020;20:00;7;2;5
streda;19.2.2020;21:00;2;1;1
streda;19.2.2020;22:00;1;1;0
streda;19.2.2020;23:00;1;1;0
štvrtok;20.2.2020;0:00;0;0;0
štvrtok;20.2.2020;1:00;0;0;0
štvrtok;20.2.2020;2:00;0;0;0
štvrtok;20.2.2020;3:00;0;0;0
štvrtok;20.2.2020;4:00;0;0;0
štvrtok;20.2.2020;5:00;1;1;0
štvrtok;20.2.2020;6:00;5;3;2
štvrtok;20.2.2020;7:00;21;10;11
štvrtok;20.2.2020;8:00;20;9;11
štvrtok;20.2.2020;9:00;22;14;8
štvrtok;20.2.2020;10:00;14;7;7
štvrtok;20.2.2020;11:00;32;17;15
štvrtok;20.2.2020;12:00;20;13;7
štvrtok;20.2.2020;13:00;22;13;9
štvrtok;20.2.2020;14:00;41;28;13
štvrtok;20.2.2020;15:00;59;29;30
štvrtok;20.2.2020;16:00;78;39;39
štvrtok;20.2.2020;17:00;47;25;22
štvrtok;20.2.2020;18:00;18;13;5
štvrtok;20.2.2020;19:00;10;4;6
štvrtok;20.2.2020;20:00;13;8;5
štvrtok;20.2.2020;21:00;5;2;3
štvrtok;20.2.2020;22:00;4;3;1
štvrtok;20.2.2020;23:00;4;3;1
piatok;21.2.2020;0:00;1;0;1
piatok;21.2.2020;1:00;1;1;0
piatok;21.2.2020;2:00;0;0;0
piatok;21.2.2020;3:00;0;0;0
piatok;21.2.2020;4:00;0;0;0
piatok;21.2.2020;5:00;4;2;2
piatok;21.2.2020;6:00;6;3;3
piatok;21.2.2020;7:00;12;8;4
piatok;21.2.2020;8:00;13;5;8
piatok;21.2.2020;9:00;5;1;4
piatok;21.2.2020;10:00;7;1;6
piatok;21.2.2020;11:00;5;2;3
piatok;21.2.2020;12:00;2;1;1
piatok;21.2.2020;13:00;5;4;1
piatok;21.2.2020;14:00;6;1;5
piatok;21.2.2020;15:00;18;11;7
piatok;21.2.2020;16:00;17;9;8
piatok;21.2.2020;17:00;17;8;9
piatok;21.2.2020;18:00;4;2;2
piatok;21.2.2020;19:00;3;2;1
piatok;21.2.2020;20:00;3;1;2
piatok;21.2.2020;21:00;1;1;0
piatok;21.2.2020;22:00;0;0;0
piatok;21.2.2020;23:00;1;1;0
sobota;22.2.2020;0:00;0;0;0
sobota;22.2.2020;1:00;1;1;0
sobota;22.2.2020;2:00;0;0;0
sobota;22.2.2020;3:00;1;1;0
sobota;22.2.2020;4:00;1;0;1
sobota;22.2.2020;5:00;0;0;0
sobota;22.2.2020;6:00;2;2;0
sobota;22.2.2020;7:00;5;5;0
sobota;22.2.2020;8:00;12;5;7
sobota;22.2.2020;9:00;30;22;8
sobota;22.2.2020;10:00;85;62;23
sobota;22.2.2020;11:00;57;34;23
sobota;22.2.2020;12:00;86;64;22
sobota;22.2.2020;13:00;105;57;48
sobota;22.2.2020;14:00;129;78;51
sobota;22.2.2020;15:00;94;46;48
sobota;22.2.2020;16:00;100;40;60
sobota;22.2.2020;17:00;31;10;21
sobota;22.2.2020;18:00;14;4;10
sobota;22.2.2020;19:00;9;4;5
sobota;22.2.2020;20:00;5;4;1
sobota;22.2.2020;21:00;3;2;1
sobota;22.2.2020;22:00;2;0;2
sobota;22.2.2020;23:00;4;3;1
nede?a;23.2.2020;0:00;0;0;0
nede?a;23.2.2020;1:00;0;0;0
nede?a;23.2.2020;2:00;0;0;0
nede?a;23.2.2020;3:00;0;0;0
nede?a;23.2.2020;4:00;0;0;0
nede?a;23.2.2020;5:00;0;0;0
nede?a;23.2.2020;6:00;0;0;0
nede?a;23.2.2020;7:00;0;0;0
nede?a;23.2.2020;8:00;3;2;1
nede?a;23.2.2020;9:00;7;3;4
nede?a;23.2.2020;10:00;25;18;7
nede?a;23.2.2020;11:00;25;13;12
nede?a;23.2.2020;12:00;25;15;10
nede?a;23.2.2020;13:00;11;8;3
nede?a;23.2.2020;14:00;10;7;3
nede?a;23.2.2020;15:00;6;2;4
nede?a;23.2.2020;16:00;5;1;4
nede?a;23.2.2020;17:00;5;1;4
nede?a;23.2.2020;18:00;2;0;2
nede?a;23.2.2020;19:00;1;1;0
nede?a;23.2.2020;20:00;7;5;2
nede?a;23.2.2020;21:00;1;0;1
nede?a;23.2.2020;22:00;2;1;1
nede?a;23.2.2020;23:00;0;0;0
pondelok;24.2.2020;0:00;0;0;0
pondelok;24.2.2020;1:00;0;0;0
pondelok;24.2.2020;2:00;0;0;0
pondelok;24.2.2020;3:00;0;0;0
pondelok;24.2.2020;4:00;0;0;0
pondelok;24.2.2020;5:00;1;1;0
pondelok;24.2.2020;6:00;3;0;3
pondelok;24.2.2020;7:00;13;4;9
pondelok;24.2.2020;8:00;30;9;21
pondelok;24.2.2020;9:00;15;10;5
pondelok;24.2.2020;10:00;11;5;6
pondelok;24.2.2020;11:00;8;5;3
pondelok;24.2.2020;12:00;9;4;5
pondelok;24.2.2020;13:00;17;10;7
pondelok;24.2.2020;14:00;30;22;8
pondelok;24.2.2020;15:00;39;19;20
pondelok;24.2.2020;16:00;40;25;15
pondelok;24.2.2020;17:00;41;26;15
pondelok;24.2.2020;18:00;17;9;8
pondelok;24.2.2020;19:00;5;2;3
pondelok;24.2.2020;20:00;7;5;2
pondelok;24.2.2020;21:00;6;4;2
pondelok;24.2.2020;22:00;2;0;2
pondelok;24.2.2020;23:00;2;1;1
utorok;25.2.2020;0:00;0;0;0
utorok;25.2.2020;1:00;0;0;0
utorok;25.2.2020;2:00;0;0;0
utorok;25.2.2020;3:00;0;0;0
utorok;25.2.2020;4:00;0;0;0
utorok;25.2.2020;5:00;2;0;2
utorok;25.2.2020;6:00;20;13;7
utorok;25.2.2020;7:00;28;12;16
utorok;25.2.2020;8:00;47;21;26
utorok;25.2.2020;9:00;20;6;14
utorok;25.2.2020;10:00;16;10;6
utorok;25.2.2020;11:00;23;14;9
utorok;25.2.2020;12:00;32;22;10
utorok;25.2.2020;13:00;28;13;15
utorok;25.2.2020;14:00;57;31;26
utorok;25.2.2020;15:00;70;46;24
utorok;25.2.2020;16:00;92;43;49
utorok;25.2.2020;17:00;72;31;41
utorok;25.2.2020;18:00;35;22;13
utorok;25.2.2020;19:00;23;16;7
utorok;25.2.2020;20:00;9;6;3
utorok;25.2.2020;21:00;8;6;2
utorok;25.2.2020;22:00;2;1;1
utorok;25.2.2020;23:00;3;1;2
streda;26.2.2020;0:00;1;0;1
streda;26.2.2020;1:00;0;0;0
streda;26.2.2020;2:00;0;0;0
streda;26.2.2020;3:00;0;0;0
streda;26.2.2020;4:00;0;0;0
streda;26.2.2020;5:00;0;0;0
streda;26.2.2020;6:00;6;5;1
streda;26.2.2020;7:00;11;5;6
streda;26.2.2020;8:00;24;6;18
streda;26.2.2020;9:00;13;6;7
streda;26.2.2020;10:00;7;1;6
streda;26.2.2020;11:00;4;3;1
streda;26.2.2020;12:00;6;4;2
streda;26.2.2020;13:00;9;5;4
streda;26.2.2020;14:00;17;11;6
streda;26.2.2020;15:00;21;12;9
streda;26.2.2020;16:00;33;15;18
streda;26.2.2020;17:00;38;23;15
streda;26.2.2020;18:00;17;7;10
streda;26.2.2020;19:00;5;1;4
streda;26.2.2020;20:00;6;4;2
streda;26.2.2020;21:00;4;3;1
streda;26.2.2020;22:00;5;3;2
streda;26.2.2020;23:00;1;1;0
štvrtok;27.2.2020;0:00;0;0;0
štvrtok;27.2.2020;1:00;1;1;0
štvrtok;27.2.2020;2:00;0;0;0
štvrtok;27.2.2020;3:00;0;0;0
štvrtok;27.2.2020;4:00;1;0;1
štvrtok;27.2.2020;5:00;4;1;3
štvrtok;27.2.2020;6:00;10;5;5
štvrtok;27.2.2020;7:00;25;9;16
štvrtok;27.2.2020;8:00;26;10;16
štvrtok;27.2.2020;9:00;12;6;6
štvrtok;27.2.2020;10:00;6;5;1
štvrtok;27.2.2020;11:00;17;7;10
štvrtok;27.2.2020;12:00;18;8;10
štvrtok;27.2.2020;13:00;21;7;14
štvrtok;27.2.2020;14:00;27;17;10
štvrtok;27.2.2020;15:00;47;29;18
štvrtok;27.2.2020;16:00;39;22;17
štvrtok;27.2.2020;17:00;54;32;22
štvrtok;27.2.2020;18:00;34;16;18
štvrtok;27.2.2020;19:00;16;8;8
štvrtok;27.2.2020;20:00;5;3;2
štvrtok;27.2.2020;21:00;2;1;1
štvrtok;27.2.2020;22:00;3;2;1
štvrtok;27.2.2020;23:00;0;0;0
piatok;28.2.2020;0:00;0;0;0
piatok;28.2.2020;1:00;0;0;0
piatok;28.2.2020;2:00;1;0;1
piatok;28.2.2020;3:00;0;0;0
piatok;28.2.2020;4:00;1;0;1
piatok;28.2.2020;5:00;0;0;0
piatok;28.2.2020;6:00;2;1;1
piatok;28.2.2020;7:00;6;2;4
piatok;28.2.2020;8:00;10;3;7
piatok;28.2.2020;9:00;1;0;1
piatok;28.2.2020;10:00;3;1;2
piatok;28.2.2020;11:00;13;7;6
piatok;28.2.2020;12:00;3;1;2
piatok;28.2.2020;13:00;6;3;3
piatok;28.2.2020;14:00;5;1;4
piatok;28.2.2020;15:00;10;6;4
piatok;28.2.2020;16:00;10;7;3
piatok;28.2.2020;17:00;10;5;5
piatok;28.2.2020;18:00;6;5;1
piatok;28.2.2020;19:00;3;2;1
piatok;28.2.2020;20:00;3;1;2
piatok;28.2.2020;21:00;0;0;0
piatok;28.2.2020;22:00;0;0;0
piatok;28.2.2020;23:00;2;1;1
sobota;29.2.2020;0:00;0;0;0
sobota;29.2.2020;1:00;0;0;0
sobota;29.2.2020;2:00;0;0;0
sobota;29.2.2020;3:00;0;0;0
sobota;29.2.2020;4:00;0;0;0
sobota;29.2.2020;5:00;0;0;0
sobota;29.2.2020;6:00;3;3;0
sobota;29.2.2020;7:00;3;0;3
sobota;29.2.2020;8:00;2;1;1
sobota;29.2.2020;9:00;7;5;2
sobota;29.2.2020;10:00;37;30;7
sobota;29.2.2020;11:00;34;21;13
sobota;29.2.2020;12:00;30;16;14
sobota;29.2.2020;13:00;64;42;22
sobota;29.2.2020;14:00;53;26;27
sobota;29.2.2020;15:00;32;19;13
sobota;29.2.2020;16:00;43;18;25
sobota;29.2.2020;17:00;21;10;11
sobota;29.2.2020;18:00;9;2;7
sobota;29.2.2020;19:00;10;6;4
sobota;29.2.2020;20:00;9;3;6
sobota;29.2.2020;21:00;3;1;2
sobota;29.2.2020;22:00;7;1;6
sobota;29.2.2020;23:00;0;0;0
nede?a;1.3.2020;0:00;0;0;0
nede?a;1.3.2020;1:00;1;0;1
nede?a;1.3.2020;2:00;1;0;1
nede?a;1.3.2020;3:00;0;0;0
nede?a;1.3.2020;4:00;0;0;0
nede?a;1.3.2020;5:00;1;0;1
nede?a;1.3.2020;6:00;2;2;0
nede?a;1.3.2020;7:00;4;2;2
nede?a;1.3.2020;8:00;6;3;3
nede?a;1.3.2020;9:00;12;10;2
nede?a;1.3.2020;10:00;27;14;13
nede?a;1.3.2020;11:00;41;27;14
nede?a;1.3.2020;12:00;36;12;24
nede?a;1.3.2020;13:00;28;16;12
nede?a;1.3.2020;14:00;24;13;11
nede?a;1.3.2020;15:00;33;17;16
nede?a;1.3.2020;16:00;9;5;4
nede?a;1.3.2020;17:00;7;6;1
nede?a;1.3.2020;18:00;7;3;4
nede?a;1.3.2020;19:00;2;0;2
nede?a;1.3.2020;20:00;0;0;0
nede?a;1.3.2020;21:00;0;0;0
nede?a;1.3.2020;22:00;0;0;0
nede?a;1.3.2020;23:00;4;2;2
pondelok;2.3.2020;0:00;1;0;1
pondelok;2.3.2020;1:00;0;0;0
pondelok;2.3.2020;2:00;0;0;0
pondelok;2.3.2020;3:00;0;0;0
pondelok;2.3.2020;4:00;0;0;0
pondelok;2.3.2020;5:00;1;0;1
pondelok;2.3.2020;6:00;3;2;1
pondelok;2.3.2020;7:00;15;7;8
pondelok;2.3.2020;8:00;22;7;15
pondelok;2.3.2020;9:00;14;6;8
pondelok;2.3.2020;10:00;8;4;4
pondelok;2.3.2020;11:00;18;13;5
pondelok;2.3.2020;12:00;31;17;14
pondelok;2.3.2020;13:00;30;11;19
pondelok;2.3.2020;14:00;57;39;18
pondelok;2.3.2020;15:00;48;28;20
pondelok;2.3.2020;16:00;70;37;33
pondelok;2.3.2020;17:00;69;38;31
pondelok;2.3.2020;18:00;35;19;16
pondelok;2.3.2020;19:00;12;8;4
pondelok;2.3.2020;20:00;6;3;3
pondelok;2.3.2020;21:00;4;1;3
pondelok;2.3.2020;22:00;1;0;1
pondelok;2.3.2020;23:00;2;1;1
utorok;3.3.2020;0:00;1;1;0
utorok;3.3.2020;1:00;0;0;0
utorok;3.3.2020;2:00;0;0;0
utorok;3.3.2020;3:00;0;0;0
utorok;3.3.2020;4:00;0;0;0
utorok;3.3.2020;5:00;1;0;1
utorok;3.3.2020;6:00;7;3;4
utorok;3.3.2020;7:00;4;1;3
utorok;3.3.2020;8:00;8;5;3
utorok;3.3.2020;9:00;3;0;3
utorok;3.3.2020;10:00;5;1;4
utorok;3.3.2020;11:00;5;3;2
utorok;3.3.2020;12:00;1;0;1
utorok;3.3.2020;13:00;5;1;4
utorok;3.3.2020;14:00;11;8;3
utorok;3.3.2020;15:00;23;17;6
utorok;3.3.2020;16:00;48;13;35
utorok;3.3.2020;17:00;49;38;11
utorok;3.3.2020;18:00;9;2;7
utorok;3.3.2020;19:00;7;2;5
utorok;3.3.2020;20:00;7;4;3
utorok;3.3.2020;21:00;3;1;2
utorok;3.3.2020;22:00;3;3;0
utorok;3.3.2020;23:00;2;1;1
streda;4.3.2020;0:00;1;0;1
streda;4.3.2020;1:00;0;0;0
streda;4.3.2020;2:00;0;0;0
streda;4.3.2020;3:00;0;0;0
streda;4.3.2020;4:00;0;0;0
streda;4.3.2020;5:00;4;3;1
streda;4.3.2020;6:00;14;9;5
streda;4.3.2020;7:00;23;11;12
streda;4.3.2020;8:00;31;14;17
streda;4.3.2020;9:00;16;8;8
streda;4.3.2020;10:00;35;11;24
streda;4.3.2020;11:00;24;13;11
streda;4.3.2020;12:00;25;11;14
streda;4.3.2020;13:00;22;11;11
streda;4.3.2020;14:00;36;15;21
streda;4.3.2020;15:00;41;23;18
streda;4.3.2020;16:00;98;49;49
streda;4.3.2020;17:00;82;51;31
streda;4.3.2020;18:00;32;9;23
streda;4.3.2020;19:00;24;11;13
streda;4.3.2020;20:00;8;3;5
streda;4.3.2020;21:00;4;2;2
streda;4.3.2020;22:00;2;1;1
streda;4.3.2020;23:00;6;4;2
štvrtok;5.3.2020;0:00;0;0;0
štvrtok;5.3.2020;1:00;2;0;2
štvrtok;5.3.2020;2:00;0;0;0
štvrtok;5.3.2020;3:00;0;0;0
štvrtok;5.3.2020;4:00;0;0;0
štvrtok;5.3.2020;5:00;2;1;1
štvrtok;5.3.2020;6:00;12;7;5
štvrtok;5.3.2020;7:00;17;6;11
štvrtok;5.3.2020;8:00;40;18;22
štvrtok;5.3.2020;9:00;25;13;12
štvrtok;5.3.2020;10:00;28;18;10
štvrtok;5.3.2020;11:00;21;12;9
štvrtok;5.3.2020;12:00;42;21;21
štvrtok;5.3.2020;13:00;39;25;14
štvrtok;5.3.2020;14:00;55;30;25
štvrtok;5.3.2020;15:00;61;35;26
štvrtok;5.3.2020;16:00;78;40;38
štvrtok;5.3.2020;17:00;93;51;42
štvrtok;5.3.2020;18:00;34;16;18
štvrtok;5.3.2020;19:00;17;6;11
štvrtok;5.3.2020;20:00;8;7;1
štvrtok;5.3.2020;21:00;2;1;1
štvrtok;5.3.2020;22:00;5;2;3
štvrtok;5.3.2020;23:00;0;0;0
piatok;6.3.2020;0:00;0;0;0
piatok;6.3.2020;1:00;0;0;0
piatok;6.3.2020;2:00;0;0;0
piatok;6.3.2020;3:00;0;0;0
piatok;6.3.2020;4:00;0;0;0
piatok;6.3.2020;5:00;0;0;0
piatok;6.3.2020;6:00;1;1;0
piatok;6.3.2020;7:00;5;2;3
piatok;6.3.2020;8:00;4;1;3
piatok;6.3.2020;9:00;1;0;1
piatok;6.3.2020;10:00;1;1;0
piatok;6.3.2020;11:00;2;0;2
piatok;6.3.2020;12:00;1;0;1
piatok;6.3.2020;13:00;3;1;2
piatok;6.3.2020;14:00;11;7;4
piatok;6.3.2020;15:00;16;8;8
piatok;6.3.2020;16:00;21;8;13
piatok;6.3.2020;17:00;17;10;7
piatok;6.3.2020;18:00;9;6;3
piatok;6.3.2020;19:00;5;4;1
piatok;6.3.2020;20:00;1;1;0
piatok;6.3.2020;21:00;2;2;0
piatok;6.3.2020;22:00;0;0;0
piatok;6.3.2020;23:00;1;0;1
sobota;7.3.2020;0:00;1;0;1
sobota;7.3.2020;1:00;0;0;0
sobota;7.3.2020;2:00;0;0;0
sobota;7.3.2020;3:00;0;0;0
sobota;7.3.2020;4:00;0;0;0
sobota;7.3.2020;5:00;2;1;1
sobota;7.3.2020;6:00;3;2;1
sobota;7.3.2020;7:00;4;2;2
sobota;7.3.2020;8:00;12;8;4
sobota;7.3.2020;9:00;32;20;12
sobota;7.3.2020;10:00;74;51;23
sobota;7.3.2020;11:00;39;16;23
sobota;7.3.2020;12:00;66;28;38
sobota;7.3.2020;13:00;46;24;22
sobota;7.3.2020;14:00;54;27;27
sobota;7.3.2020;15:00;30;15;15
sobota;7.3.2020;16:00;35;13;22
sobota;7.3.2020;17:00;21;8;13
sobota;7.3.2020;18:00;11;3;8
sobota;7.3.2020;19:00;10;8;2
sobota;7.3.2020;20:00;4;1;3
sobota;7.3.2020;21:00;1;0;1
sobota;7.3.2020;22:00;2;2;0
sobota;7.3.2020;23:00;0;0;0
nede?a;8.3.2020;0:00;1;0;1
nede?a;8.3.2020;1:00;1;0;1
nede?a;8.3.2020;2:00;0;0;0
nede?a;8.3.2020;3:00;0;0;0
nede?a;8.3.2020;4:00;1;0;1
nede?a;8.3.2020;5:00;0;0;0
nede?a;8.3.2020;6:00;2;2;0
nede?a;8.3.2020;7:00;3;3;0
nede?a;8.3.2020;8:00;8;7;1
nede?a;8.3.2020;9:00;44;26;18
nede?a;8.3.2020;10:00;102;81;21
nede?a;8.3.2020;11:00;65;40;25
nede?a;8.3.2020;12:00;100;43;57
nede?a;8.3.2020;13:00;138;72;66
nede?a;8.3.2020;14:00;136;73;63
nede?a;8.3.2020;15:00;122;56;66
nede?a;8.3.2020;16:00;123;59;64
nede?a;8.3.2020;17:00;61;37;24
nede?a;8.3.2020;18:00;23;11;12
nede?a;8.3.2020;19:00;4;1;3
nede?a;8.3.2020;20:00;3;2;1
nede?a;8.3.2020;21:00;1;1;0
nede?a;8.3.2020;22:00;0;0;0
nede?a;8.3.2020;23:00;2;1;1
pondelok;9.3.2020;0:00;0;0;0
pondelok;9.3.2020;1:00;0;0;0
pondelok;9.3.2020;2:00;0;0;0
pondelok;9.3.2020;3:00;0;0;0
pondelok;9.3.2020;4:00;0;0;0
pondelok;9.3.2020;5:00;1;0;1
pondelok;9.3.2020;6:00;7;4;3
pondelok;9.3.2020;7:00;23;8;15
pondelok;9.3.2020;8:00;31;18;13
pondelok;9.3.2020;9:00;20;7;13
pondelok;9.3.2020;10:00;12;6;6
pondelok;9.3.2020;11:00;15;11;4
pondelok;9.3.2020;12:00;15;7;8
pondelok;9.3.2020;13:00;24;14;10
pondelok;9.3.2020;14:00;23;14;9
pondelok;9.3.2020;15:00;57;38;19
pondelok;9.3.2020;16:00;66;40;26
pondelok;9.3.2020;17:00;69;37;32
pondelok;9.3.2020;18:00;43;22;21
pondelok;9.3.2020;19:00;23;17;6
pondelok;9.3.2020;20:00;6;2;4
pondelok;9.3.2020;21:00;7;3;4
pondelok;9.3.2020;22:00;1;1;0
pondelok;9.3.2020;23:00;0;0;0
utorok;10.3.2020;0:00;0;0;0
utorok;10.3.2020;1:00;0;0;0
utorok;10.3.2020;2:00;0;0;0
utorok;10.3.2020;3:00;0;0;0
utorok;10.3.2020;4:00;0;0;0
utorok;10.3.2020;5:00;0;0;0
utorok;10.3.2020;6:00;14;7;7
utorok;10.3.2020;7:00;28;14;14
utorok;10.3.2020;8:00;36;19;17
utorok;10.3.2020;9:00;27;13;14
utorok;10.3.2020;10:00;35;19;16
utorok;10.3.2020;11:00;31;18;13
utorok;10.3.2020;12:00;52;31;21
utorok;10.3.2020;13:00;46;23;23
utorok;10.3.2020;14:00;62;28;34
utorok;10.3.2020;15:00;112;70;42
utorok;10.3.2020;16:00;124;71;53
utorok;10.3.2020;17:00;114;67;47
utorok;10.3.2020;18:00;40;19;21
utorok;10.3.2020;19:00;15;6;9
utorok;10.3.2020;20:00;9;2;7
utorok;10.3.2020;21:00;5;4;1
utorok;10.3.2020;22:00;6;3;3
utorok;10.3.2020;23:00;3;1;2
streda;11.3.2020;0:00;0;0;0
streda;11.3.2020;1:00;0;0;0
streda;11.3.2020;2:00;0;0;0
streda;11.3.2020;3:00;0;0;0
streda;11.3.2020;4:00;0;0;0
streda;11.3.2020;5:00;1;0;1
streda;11.3.2020;6:00;4;2;2
streda;11.3.2020;7:00;11;3;8
streda;11.3.2020;8:00;22;9;13
streda;11.3.2020;9:00;13;8;5
streda;11.3.2020;10:00;5;3;2
streda;11.3.2020;11:00;6;2;4
streda;11.3.2020;12:00;16;6;10
streda;11.3.2020;13:00;23;16;7
streda;11.3.2020;14:00;32;16;16
streda;11.3.2020;15:00;60;33;27
streda;11.3.2020;16:00;84;46;38
streda;11.3.2020;17:00;97;55;42
streda;11.3.2020;18:00;41;23;18
streda;11.3.2020;19:00;21;13;8
streda;11.3.2020;20:00;20;6;14
streda;11.3.2020;21:00;7;1;6
streda;11.3.2020;22:00;1;1;0
streda;11.3.2020;23:00;1;1;0
štvrtok;12.3.2020;0:00;1;0;1
štvrtok;12.3.2020;1:00;2;0;2
štvrtok;12.3.2020;2:00;1;1;0
štvrtok;12.3.2020;3:00;0;0;0
štvrtok;12.3.2020;4:00;1;0;1
štvrtok;12.3.2020;5:00;3;3;0
štvrtok;12.3.2020;6:00;26;14;12
štvrtok;12.3.2020;7:00;40;23;17
štvrtok;12.3.2020;8:00;53;23;30
štvrtok;12.3.2020;9:00;42;24;18
štvrtok;12.3.2020;10:00;81;48;33
štvrtok;12.3.2020;11:00;87;49;38
štvrtok;12.3.2020;12:00;106;54;52
štvrtok;12.3.2020;13:00;116;70;46
štvrtok;12.3.2020;14:00;159;100;59
štvrtok;12.3.2020;15:00;215;121;94
štvrtok;12.3.2020;16:00;253;124;129
štvrtok;12.3.2020;17:00;209;108;101
štvrtok;12.3.2020;18:00;93;63;30
štvrtok;12.3.2020;19:00;25;13;12
štvrtok;12.3.2020;20:00;14;9;5
štvrtok;12.3.2020;21:00;12;7;5
štvrtok;12.3.2020;22:00;1;0;1
štvrtok;12.3.2020;23:00;4;2;2
piatok;13.3.2020;0:00;0;0;0
piatok;13.3.2020;1:00;0;0;0
piatok;13.3.2020;2:00;0;0;0
piatok;13.3.2020;3:00;0;0;0
piatok;13.3.2020;4:00;1;0;1
piatok;13.3.2020;5:00;1;0;1
piatok;13.3.2020;6:00;1;0;1
piatok;13.3.2020;7:00;11;3;8
piatok;13.3.2020;8:00;7;5;2
piatok;13.3.2020;9:00;10;7;3
piatok;13.3.2020;10:00;6;2;4
piatok;13.3.2020;11:00;9;5;4
piatok;13.3.2020;12:00;10;7;3
piatok;13.3.2020;13:00;15;10;5
piatok;13.3.2020;14:00;24;13;11
piatok;13.3.2020;15:00;41;24;17
piatok;13.3.2020;16:00;55;33;22
piatok;13.3.2020;17:00;52;28;24
piatok;13.3.2020;18:00;19;11;8
piatok;13.3.2020;19:00;9;3;6
piatok;13.3.2020;20:00;5;4;1
piatok;13.3.2020;21:00;5;2;3
piatok;13.3.2020;22:00;2;2;0
piatok;13.3.2020;23:00;1;1;0
sobota;14.3.2020;0:00;2;1;1
sobota;14.3.2020;1:00;0;0;0
sobota;14.3.2020;2:00;0;0;0
sobota;14.3.2020;3:00;2;1;1
sobota;14.3.2020;4:00;0;0;0
sobota;14.3.2020;5:00;0;0;0
sobota;14.3.2020;6:00;7;4;3
sobota;14.3.2020;7:00;2;1;1
sobota;14.3.2020;8:00;10;8;2
sobota;14.3.2020;9:00;35;13;22
sobota;14.3.2020;10:00;52;30;22
sobota;14.3.2020;11:00;77;49;28
sobota;14.3.2020;12:00;89;56;33
sobota;14.3.2020;13:00;100;64;36
sobota;14.3.2020;14:00;131;69;62
sobota;14.3.2020;15:00;129;67;62
sobota;14.3.2020;16:00;117;58;59
sobota;14.3.2020;17:00;83;52;31
sobota;14.3.2020;18:00;20;13;7
sobota;14.3.2020;19:00;5;3;2
sobota;14.3.2020;20:00;6;4;2
sobota;14.3.2020;21:00;3;0;3
sobota;14.3.2020;22:00;1;0;1
sobota;14.3.2020;23:00;2;1;1
nede?a;15.3.2020;0:00;0;0;0
nede?a;15.3.2020;1:00;0;0;0
nede?a;15.3.2020;2:00;0;0;0
nede?a;15.3.2020;3:00;0;0;0
nede?a;15.3.2020;4:00;0;0;0
nede?a;15.3.2020;5:00;1;0;1
nede?a;15.3.2020;6:00;1;1;0
nede?a;15.3.2020;7:00;5;3;2
nede?a;15.3.2020;8:00;8;7;1
nede?a;15.3.2020;9:00;17;7;10
nede?a;15.3.2020;10:00;45;21;24
nede?a;15.3.2020;11:00;71;36;35
nede?a;15.3.2020;12:00;91;59;32
nede?a;15.3.2020;13:00;82;52;30
nede?a;15.3.2020;14:00;120;71;49
nede?a;15.3.2020;15:00;155;82;73
nede?a;15.3.2020;16:00;113;64;49
nede?a;15.3.2020;17:00;64;28;36
nede?a;15.3.2020;18:00;28;21;7
nede?a;15.3.2020;19:00;5;2;3
nede?a;15.3.2020;20:00;0;0;0
nede?a;15.3.2020;21:00;2;1;1
nede?a;15.3.2020;22:00;0;0;0
nede?a;15.3.2020;23:00;3;2;1
pondelok;16.3.2020;0:00;1;0;1
pondelok;16.3.2020;1:00;0;0;0
pondelok;16.3.2020;2:00;0;0;0
pondelok;16.3.2020;3:00;0;0;0
pondelok;16.3.2020;4:00;0;0;0
pondelok;16.3.2020;5:00;2;1;1
pondelok;16.3.2020;6:00;8;4;4
pondelok;16.3.2020;7:00;11;5;6
pondelok;16.3.2020;8:00;19;10;9
pondelok;16.3.2020;9:00;12;4;8
pondelok;16.3.2020;10:00;12;6;6
pondelok;16.3.2020;11:00;19;8;11
pondelok;16.3.2020;12:00;22;12;10
pondelok;16.3.2020;13:00;33;13;20
pondelok;16.3.2020;14:00;47;23;24
pondelok;16.3.2020;15:00;57;36;21
pondelok;16.3.2020;16:00;81;54;27
pondelok;16.3.2020;17:00;68;34;34
pondelok;16.3.2020;18:00;29;17;12
pondelok;16.3.2020;19:00;16;10;6
pondelok;16.3.2020;20:00;9;3;6
pondelok;16.3.2020;21:00;5;3;2
pondelok;16.3.2020;22:00;0;0;0
pondelok;16.3.2020;23:00;0;0;0
utorok;17.3.2020;0:00;1;1;0
utorok;17.3.2020;1:00;0;0;0
utorok;17.3.2020;2:00;0;0;0
utorok;17.3.2020;3:00;0;0;0
utorok;17.3.2020;4:00;0;0;0
utorok;17.3.2020;5:00;0;0;0
utorok;17.3.2020;6:00;9;6;3
utorok;17.3.2020;7:00;19;10;9
utorok;17.3.2020;8:00;19;8;11
utorok;17.3.2020;9:00;14;8;6
utorok;17.3.2020;10:00;26;14;12
utorok;17.3.2020;11:00;39;24;15
utorok;17.3.2020;12:00;52;27;25
utorok;17.3.2020;13:00;40;19;21
utorok;17.3.2020;14:00;60;32;28
utorok;17.3.2020;15:00;70;45;25
utorok;17.3.2020;16:00;63;28;35
utorok;17.3.2020;17:00;68;42;26
utorok;17.3.2020;18:00;31;16;15
utorok;17.3.2020;19:00;8;6;2
utorok;17.3.2020;20:00;8;4;4
utorok;17.3.2020;21:00;3;2;1
utorok;17.3.2020;22:00;1;1;0
utorok;17.3.2020;23:00;3;1;2
streda;18.3.2020;0:00;0;0;0
streda;18.3.2020;1:00;0;0;0
streda;18.3.2020;2:00;0;0;0
streda;18.3.2020;3:00;0;0;0
streda;18.3.2020;4:00;1;0;1
streda;18.3.2020;5:00;0;0;0
streda;18.3.2020;6:00;9;6;3
streda;18.3.2020;7:00;24;15;9
streda;18.3.2020;8:00;25;11;14
streda;18.3.2020;9:00;18;10;8
streda;18.3.2020;10:00;46;16;30
streda;18.3.2020;11:00;84;50;34
streda;18.3.2020;12:00;106;64;42
streda;18.3.2020;13:00;119;62;57
streda;18.3.2020;14:00;169;81;88
streda;18.3.2020;15:00;213;122;91
streda;18.3.2020;16:00;253;168;85
streda;18.3.2020;17:00;201;110;91
streda;18.3.2020;18:00;80;51;29
streda;18.3.2020;19:00;21;12;9
streda;18.3.2020;20:00;4;3;1
streda;18.3.2020;21:00;5;3;2
streda;18.3.2020;22:00;1;0;1
streda;18.3.2020;23:00;2;1;1
štvrtok;19.3.2020;0:00;2;1;1
štvrtok;19.3.2020;1:00;0;0;0
štvrtok;19.3.2020;2:00;0;0;0
štvrtok;19.3.2020;3:00;0;0;0
štvrtok;19.3.2020;4:00;0;0;0
štvrtok;19.3.2020;5:00;3;0;3
štvrtok;19.3.2020;6:00;14;8;6
štvrtok;19.3.2020;7:00;21;11;10
štvrtok;19.3.2020;8:00;34;18;16
štvrtok;19.3.2020;9:00;30;14;16
štvrtok;19.3.2020;10:00;53;27;26
štvrtok;19.3.2020;11:00;72;34;38
štvrtok;19.3.2020;12:00;87;51;36
štvrtok;19.3.2020;13:00;110;67;43
štvrtok;19.3.2020;14:00;194;114;80
štvrtok;19.3.2020;15:00;244;139;105
štvrtok;19.3.2020;16:00;267;160;107
štvrtok;19.3.2020;17:00;267;155;112
štvrtok;19.3.2020;18:00;97;60;37
štvrtok;19.3.2020;19:00;26;17;9
štvrtok;19.3.2020;20:00;6;3;3
štvrtok;19.3.2020;21:00;7;5;2
štvrtok;19.3.2020;22:00;0;0;0
štvrtok;19.3.2020;23:00;1;0;1
piatok;20.3.2020;0:00;0;0;0
piatok;20.3.2020;1:00;0;0;0
piatok;20.3.2020;2:00;0;0;0
piatok;20.3.2020;3:00;0;0;0
piatok;20.3.2020;4:00;0;0;0
piatok;20.3.2020;5:00;1;1;0
piatok;20.3.2020;6:00;17;12;5
piatok;20.3.2020;7:00;21;15;6
piatok;20.3.2020;8:00;32;16;16
piatok;20.3.2020;9:00;25;12;13
piatok;20.3.2020;10:00;34;16;18
piatok;20.3.2020;11:00;58;28;30
piatok;20.3.2020;12:00;92;55;37
piatok;20.3.2020;13:00;152;74;78
piatok;20.3.2020;14:00;188;103;85
piatok;20.3.2020;15:00;280;146;134
piatok;20.3.2020;16:00;291;178;113
piatok;20.3.2020;17:00;244;141;103
piatok;20.3.2020;18:00;94;51;43
piatok;20.3.2020;19:00;26;13;13
piatok;20.3.2020;20:00;10;4;6
piatok;20.3.2020;21:00;7;5;2
piatok;20.3.2020;22:00;3;2;1
piatok;20.3.2020;23:00;4;4;0
sobota;21.3.2020;0:00;1;0;1
sobota;21.3.2020;1:00;0;0;0
sobota;21.3.2020;2:00;0;0;0
sobota;21.3.2020;3:00;0;0;0
sobota;21.3.2020;4:00;0;0;0
sobota;21.3.2020;5:00;0;0;0
sobota;21.3.2020;6:00;1;0;1
sobota;21.3.2020;7:00;1;0;1
sobota;21.3.2020;8:00;0;0;0
sobota;21.3.2020;9:00;1;1;0
sobota;21.3.2020;10:00;1;1;0
sobota;21.3.2020;11:00;3;0;3
sobota;21.3.2020;12:00;3;1;2
sobota;21.3.2020;13:00;11;8;3
sobota;21.3.2020;14:00;21;10;11
sobota;21.3.2020;15:00;17;6;11
sobota;21.3.2020;16:00;8;3;5
sobota;21.3.2020;17:00;17;6;11
sobota;21.3.2020;18:00;5;3;2
sobota;21.3.2020;19:00;0;0;0
sobota;21.3.2020;20:00;2;2;0
sobota;21.3.2020;21:00;0;0;0
sobota;21.3.2020;22:00;0;0;0
sobota;21.3.2020;23:00;0;0;0
nede?a;22.3.2020;0:00;2;1;1
nede?a;22.3.2020;1:00;0;0;0
nede?a;22.3.2020;2:00;0;0;0
nede?a;22.3.2020;3:00;0;0;0
nede?a;22.3.2020;4:00;0;0;0
nede?a;22.3.2020;5:00;0;0;0
nede?a;22.3.2020;6:00;3;2;1
nede?a;22.3.2020;7:00;3;0;3
nede?a;22.3.2020;8:00;7;5;2
nede?a;22.3.2020;9:00;8;3;5
nede?a;22.3.2020;10:00;20;15;5
nede?a;22.3.2020;11:00;42;23;19
nede?a;22.3.2020;12:00;33;18;15
nede?a;22.3.2020;13:00;41;19;22
nede?a;22.3.2020;14:00;47;26;21
nede?a;22.3.2020;15:00;47;28;19
nede?a;22.3.2020;16:00;21;11;10
nede?a;22.3.2020;17:00;21;16;5
nede?a;22.3.2020;18:00;10;5;5
nede?a;22.3.2020;19:00;6;3;3
nede?a;22.3.2020;20:00;0;0;0
nede?a;22.3.2020;21:00;2;2;0
nede?a;22.3.2020;22:00;2;0;2
nede?a;22.3.2020;23:00;0;0;0
pondelok;23.3.2020;0:00;0;0;0
pondelok;23.3.2020;1:00;0;0;0
pondelok;23.3.2020;2:00;0;0;0
pondelok;23.3.2020;3:00;0;0;0
pondelok;23.3.2020;4:00;1;0;1
pondelok;23.3.2020;5:00;0;0;0
pondelok;23.3.2020;6:00;7;5;2
pondelok;23.3.2020;7:00;6;2;4
pondelok;23.3.2020;8:00;9;5;4
pondelok;23.3.2020;9:00;13;6;7
pondelok;23.3.2020;10:00;10;4;6
pondelok;23.3.2020;11:00;15;9;6
pondelok;23.3.2020;12:00;10;5;5
pondelok;23.3.2020;13:00;26;17;9
pondelok;23.3.2020;14:00;20;7;13
pondelok;23.3.2020;15:00;17;13;4
pondelok;23.3.2020;16:00;22;9;13
pondelok;23.3.2020;17:00;20;14;6
pondelok;23.3.2020;18:00;20;12;8
pondelok;23.3.2020;19:00;3;2;1
pondelok;23.3.2020;20:00;2;1;1
pondelok;23.3.2020;21:00;0;0;0
pondelok;23.3.2020;22:00;1;0;1
pondelok;23.3.2020;23:00;1;1;0
utorok;24.3.2020;0:00;1;0;1
utorok;24.3.2020;1:00;0;0;0
utorok;24.3.2020;2:00;0;0;0
utorok;24.3.2020;3:00;0;0;0
utorok;24.3.2020;4:00;0;0;0
utorok;24.3.2020;5:00;0;0;0
utorok;24.3.2020;6:00;10;6;4
utorok;24.3.2020;7:00;7;3;4
utorok;24.3.2020;8:00;14;6;8
utorok;24.3.2020;9:00;11;5;6
utorok;24.3.2020;10:00;6;2;4
utorok;24.3.2020;11:00;15;7;8
utorok;24.3.2020;12:00;27;19;8
utorok;24.3.2020;13:00;31;16;15
utorok;24.3.2020;14:00;35;21;14
utorok;24.3.2020;15:00;67;40;27
utorok;24.3.2020;16:00;85;52;33
utorok;24.3.2020;17:00;71;39;32
utorok;24.3.2020;18:00;31;18;13
utorok;24.3.2020;19:00;12;7;5
utorok;24.3.2020;20:00;2;1;1
utorok;24.3.2020;21:00;4;3;1
utorok;24.3.2020;22:00;1;1;0
utorok;24.3.2020;23:00;2;1;1
streda;25.3.2020;0:00;0;0;0
streda;25.3.2020;1:00;0;0;0
streda;25.3.2020;2:00;0;0;0
streda;25.3.2020;3:00;0;0;0
streda;25.3.2020;4:00;0;0;0
streda;25.3.2020;5:00;3;2;1
streda;25.3.2020;6:00;4;3;1
streda;25.3.2020;7:00;8;4;4
streda;25.3.2020;8:00;13;7;6
streda;25.3.2020;9:00;8;3;5
streda;25.3.2020;10:00;10;7;3
streda;25.3.2020;11:00;5;2;3
streda;25.3.2020;12:00;15;10;5
streda;25.3.2020;13:00;11;7;4
streda;25.3.2020;14:00;10;8;2
streda;25.3.2020;15:00;10;4;6
streda;25.3.2020;16:00;22;14;8
streda;25.3.2020;17:00;13;7;6
streda;25.3.2020;18:00;12;8;4
streda;25.3.2020;19:00;4;3;1
streda;25.3.2020;20:00;1;1;0
streda;25.3.2020;21:00;1;1;0
streda;25.3.2020;22:00;0;0;0
streda;25.3.2020;23:00;2;1;1
štvrtok;26.3.2020;0:00;0;0;0
štvrtok;26.3.2020;1:00;0;0;0
štvrtok;26.3.2020;2:00;0;0;0
štvrtok;26.3.2020;3:00;0;0;0
štvrtok;26.3.2020;4:00;0;0;0
štvrtok;26.3.2020;5:00;2;1;1
štvrtok;26.3.2020;6:00;3;2;1
štvrtok;26.3.2020;7:00;10;3;7
štvrtok;26.3.2020;8:00;11;6;5
štvrtok;26.3.2020;9:00;8;4;4
štvrtok;26.3.2020;10:00;14;9;5
štvrtok;26.3.2020;11:00;17;9;8
štvrtok;26.3.2020;12:00;21;8;13
štvrtok;26.3.2020;13:00;40;22;18
štvrtok;26.3.2020;14:00;51;31;20
štvrtok;26.3.2020;15:00;71;44;27
štvrtok;26.3.2020;16:00;76;38;38
štvrtok;26.3.2020;17:00;92;52;40
štvrtok;26.3.2020;18:00;64;35;29
štvrtok;26.3.2020;19:00;15;11;4
štvrtok;26.3.2020;20:00;4;0;4
štvrtok;26.3.2020;21:00;5;1;4
štvrtok;26.3.2020;22:00;0;0;0
štvrtok;26.3.2020;23:00;1;1;0
piatok;27.3.2020;0:00;2;1;1
piatok;27.3.2020;1:00;0;0;0
piatok;27.3.2020;2:00;0;0;0
piatok;27.3.2020;3:00;0;0;0
piatok;27.3.2020;4:00;0;0;0
piatok;27.3.2020;5:00;4;3;1
piatok;27.3.2020;6:00;8;7;1
piatok;27.3.2020;7:00;12;6;6
piatok;27.3.2020;8:00;17;5;12
piatok;27.3.2020;9:00;14;8;6
piatok;27.3.2020;10:00;39;24;15
piatok;27.3.2020;11:00;67;41;26
piatok;27.3.2020;12:00;81;33;48
piatok;27.3.2020;13:00;130;58;72
piatok;27.3.2020;14:00;138;86;52
piatok;27.3.2020;15:00;203;104;99
piatok;27.3.2020;16:00;239;129;110
piatok;27.3.2020;17:00;178;108;70
piatok;27.3.2020;18:00;98;52;46
piatok;27.3.2020;19:00;17;8;9
piatok;27.3.2020;20:00;9;4;5
piatok;27.3.2020;21:00;5;2;3
piatok;27.3.2020;22:00;3;1;2
piatok;27.3.2020;23:00;2;1;1
sobota;28.3.2020;0:00;0;0;0
sobota;28.3.2020;1:00;0;0;0
sobota;28.3.2020;2:00;1;0;1
sobota;28.3.2020;3:00;0;0;0
sobota;28.3.2020;4:00;1;0;1
sobota;28.3.2020;5:00;1;0;1
sobota;28.3.2020;6:00;5;2;3
sobota;28.3.2020;7:00;7;3;4
sobota;28.3.2020;8:00;26;14;12
sobota;28.3.2020;9:00;70;44;26
sobota;28.3.2020;10:00;140;82;58
sobota;28.3.2020;11:00;164;101;63
sobota;28.3.2020;12:00;195;126;69
sobota;28.3.2020;13:00;256;147;109
sobota;28.3.2020;14:00;305;186;119
sobota;28.3.2020;15:00;304;150;154
sobota;28.3.2020;16:00;330;175;155
sobota;28.3.2020;17:00;212;111;101
sobota;28.3.2020;18:00;91;56;35
sobota;28.3.2020;19:00;12;6;6
sobota;28.3.2020;20:00;8;5;3
sobota;28.3.2020;21:00;3;2;1
sobota;28.3.2020;22:00;4;3;1
sobota;28.3.2020;23:00;1;1;0
nede?a;29.3.2020;0:00;1;0;1
nede?a;29.3.2020;1:00;0;0;0
nede?a;29.3.2020;2:00;0;;
nede?a;29.3.2020;3:00;1;1;0
nede?a;29.3.2020;4:00;0;0;0
nede?a;29.3.2020;5:00;0;0;0
nede?a;29.3.2020;6:00;4;3;1
nede?a;29.3.2020;7:00;6;4;2
nede?a;29.3.2020;8:00;10;7;3
nede?a;29.3.2020;9:00;25;17;8
nede?a;29.3.2020;10:00;66;38;28
nede?a;29.3.2020;11:00;78;48;30
nede?a;29.3.2020;12:00;121;74;47
nede?a;29.3.2020;13:00;132;85;47
nede?a;29.3.2020;14:00;155;88;67
nede?a;29.3.2020;15:00;186;101;85
nede?a;29.3.2020;16:00;130;66;64
nede?a;29.3.2020;17:00;97;58;39
nede?a;29.3.2020;18:00;70;41;29
nede?a;29.3.2020;19:00;35;15;20
nede?a;29.3.2020;20:00;6;1;5
nede?a;29.3.2020;21:00;3;1;2
nede?a;29.3.2020;22:00;3;3;0
nede?a;29.3.2020;23:00;1;1;0
pondelok;30.3.2020;0:00;2;1;1
pondelok;30.3.2020;1:00;0;0;0
pondelok;30.3.2020;2:00;0;0;0
pondelok;30.3.2020;3:00;0;0;0
pondelok;30.3.2020;4:00;0;0;0
pondelok;30.3.2020;5:00;1;1;0
pondelok;30.3.2020;6:00;6;4;2
pondelok;30.3.2020;7:00;2;1;1
pondelok;30.3.2020;8:00;8;5;3
pondelok;30.3.2020;9:00;7;2;5
pondelok;30.3.2020;10:00;3;1;2
pondelok;30.3.2020;11:00;4;3;1
pondelok;30.3.2020;12:00;7;3;4
pondelok;30.3.2020;13:00;6;2;4
pondelok;30.3.2020;14:00;9;8;1
pondelok;30.3.2020;15:00;15;11;4
pondelok;30.3.2020;16:00;25;13;12
pondelok;30.3.2020;17:00;25;14;11
pondelok;30.3.2020;18:00;20;8;12
pondelok;30.3.2020;19:00;12;7;5
pondelok;30.3.2020;20:00;10;5;5
pondelok;30.3.2020;21:00;1;0;1
pondelok;30.3.2020;22:00;2;2;0
pondelok;30.3.2020;23:00;0;0;0
utorok;31.3.2020;0:00;0;0;0
utorok;31.3.2020;1:00;0;0;0
utorok;31.3.2020;2:00;0;0;0
utorok;31.3.2020;3:00;0;0;0
utorok;31.3.2020;4:00;0;0;0
utorok;31.3.2020;5:00;1;0;1
utorok;31.3.2020;6:00;3;3;0
utorok;31.3.2020;7:00;9;4;5
utorok;31.3.2020;8:00;8;5;3
utorok;31.3.2020;9:00;12;6;6
utorok;31.3.2020;10:00;14;6;8
utorok;31.3.2020;11:00;28;17;11
utorok;31.3.2020;12:00;23;18;5
utorok;31.3.2020;13:00;32;19;13
utorok;31.3.2020;14:00;32;18;14
utorok;31.3.2020;15:00;31;14;17
utorok;31.3.2020;16:00;49;28;21
utorok;31.3.2020;17:00;40;21;19
utorok;31.3.2020;18:00;34;14;20
utorok;31.3.2020;19:00;18;10;8
utorok;31.3.2020;20:00;2;0;2
utorok;31.3.2020;21:00;4;0;4
utorok;31.3.2020;22:00;3;3;0
utorok;31.3.2020;23:00;2;1;1
streda;1.4.2020;0:00;0;0;0
streda;1.4.2020;1:00;0;0;0
streda;1.4.2020;2:00;0;0;0
streda;1.4.2020;3:00;0;0;0
streda;1.4.2020;4:00;1;0;1
streda;1.4.2020;5:00;3;1;2
streda;1.4.2020;6:00;2;1;1
streda;1.4.2020;7:00;6;6;0
streda;1.4.2020;8:00;12;4;8
streda;1.4.2020;9:00;11;7;4
streda;1.4.2020;10:00;13;9;4
streda;1.4.2020;11:00;17;6;11
streda;1.4.2020;12:00;27;14;13
streda;1.4.2020;13:00;30;17;13
streda;1.4.2020;14:00;41;23;18
streda;1.4.2020;15:00;50;30;20
streda;1.4.2020;16:00;102;63;39
streda;1.4.2020;17:00;99;47;52
streda;1.4.2020;18:00;58;41;17
streda;1.4.2020;19:00;35;22;13
streda;1.4.2020;20:00;4;2;2
streda;1.4.2020;21:00;1;0;1
streda;1.4.2020;22:00;1;1;0
streda;1.4.2020;23:00;0;0;0
štvrtok;2.4.2020;0:00;1;1;0
štvrtok;2.4.2020;1:00;2;2;0
štvrtok;2.4.2020;2:00;0;0;0
štvrtok;2.4.2020;3:00;0;0;0
štvrtok;2.4.2020;4:00;1;0;1
štvrtok;2.4.2020;5:00;1;0;1
štvrtok;2.4.2020;6:00;1;0;1
štvrtok;2.4.2020;7:00;12;6;6
štvrtok;2.4.2020;8:00;8;4;4
štvrtok;2.4.2020;9:00;12;8;4
štvrtok;2.4.2020;10:00;24;16;8
štvrtok;2.4.2020;11:00;32;13;19
štvrtok;2.4.2020;12:00;49;25;24
štvrtok;2.4.2020;13:00;39;21;18
štvrtok;2.4.2020;14:00;79;49;30
štvrtok;2.4.2020;15:00;99;53;46
štvrtok;2.4.2020;16:00;129;75;54
štvrtok;2.4.2020;17:00;134;81;53
štvrtok;2.4.2020;18:00;115;64;51
štvrtok;2.4.2020;19:00;53;31;22
štvrtok;2.4.2020;20:00;11;8;3
štvrtok;2.4.2020;21:00;5;0;5
štvrtok;2.4.2020;22:00;4;4;0
štvrtok;2.4.2020;23:00;3;2;1
piatok;3.4.2020;0:00;1;0;1
piatok;3.4.2020;1:00;0;0;0
piatok;3.4.2020;2:00;0;0;0
piatok;3.4.2020;3:00;0;0;0
piatok;3.4.2020;4:00;0;0;0
piatok;3.4.2020;5:00;1;0;1
piatok;3.4.2020;6:00;3;2;1
piatok;3.4.2020;7:00;12;6;6
piatok;3.4.2020;8:00;24;13;11
piatok;3.4.2020;9:00;18;13;5
piatok;3.4.2020;10:00;27;12;15
piatok;3.4.2020;11:00;50;27;23
piatok;3.4.2020;12:00;58;36;22
piatok;3.4.2020;13:00;49;25;24
piatok;3.4.2020;14:00;101;57;44
piatok;3.4.2020;15:00;101;61;40
piatok;3.4.2020;16:00;103;64;39
piatok;3.4.2020;17:00;104;58;46
piatok;3.4.2020;18:00;71;36;35
piatok;3.4.2020;19:00;42;25;17
piatok;3.4.2020;20:00;18;13;5
piatok;3.4.2020;21:00;3;1;2
piatok;3.4.2020;22:00;3;3;0
piatok;3.4.2020;23:00;0;0;0
sobota;4.4.2020;0:00;1;1;0
sobota;4.4.2020;1:00;2;1;1
sobota;4.4.2020;2:00;0;0;0
sobota;4.4.2020;3:00;0;0;0
sobota;4.4.2020;4:00;0;0;0
sobota;4.4.2020;5:00;1;0;1
sobota;4.4.2020;6:00;6;3;3
sobota;4.4.2020;7:00;4;3;1
sobota;4.4.2020;8:00;17;13;4
sobota;4.4.2020;9:00;43;29;14
sobota;4.4.2020;10:00;86;45;41
sobota;4.4.2020;11:00;112;75;37
sobota;4.4.2020;12:00;138;80;58
sobota;4.4.2020;13:00;161;99;62
sobota;4.4.2020;14:00;217;136;81
sobota;4.4.2020;15:00;196;96;100
sobota;4.4.2020;16:00;223;114;109
sobota;4.4.2020;17:00;180;97;83
sobota;4.4.2020;18:00;87;43;44
sobota;4.4.2020;19:00;49;27;22
sobota;4.4.2020;20:00;12;4;8
sobota;4.4.2020;21:00;3;3;0
sobota;4.4.2020;22:00;7;7;0
sobota;4.4.2020;23:00;9;3;6
nede?a;5.4.2020;0:00;2;0;2
nede?a;5.4.2020;1:00;0;0;0
nede?a;5.4.2020;2:00;0;0;0
nede?a;5.4.2020;3:00;0;0;0
nede?a;5.4.2020;4:00;0;0;0
nede?a;5.4.2020;5:00;0;0;0
nede?a;5.4.2020;6:00;1;1;0
nede?a;5.4.2020;7:00;6;2;4
nede?a;5.4.2020;8:00;17;11;6
nede?a;5.4.2020;9:00;54;33;21
nede?a;5.4.2020;10:00;90;56;34
nede?a;5.4.2020;11:00;152;86;66
nede?a;5.4.2020;12:00;144;76;68
nede?a;5.4.2020;13:00;192;103;89
nede?a;5.4.2020;14:00;282;175;107
nede?a;5.4.2020;15:00;308;175;133
nede?a;5.4.2020;16:00;274;133;141
nede?a;5.4.2020;17:00;254;132;122
nede?a;5.4.2020;18:00;117;67;50
nede?a;5.4.2020;19:00;69;38;31
nede?a;5.4.2020;20:00;18;15;3
nede?a;5.4.2020;21:00;2;1;1
nede?a;5.4.2020;22:00;4;3;1
nede?a;5.4.2020;23:00;2;1;1
pondelok;6.4.2020;0:00;0;0;0
pondelok;6.4.2020;1:00;1;0;1
pondelok;6.4.2020;2:00;0;0;0
pondelok;6.4.2020;3:00;0;0;0
pondelok;6.4.2020;4:00;0;0;0
pondelok;6.4.2020;5:00;1;1;0
pondelok;6.4.2020;6:00;13;5;8
pondelok;6.4.2020;7:00;13;8;5
pondelok;6.4.2020;8:00;21;10;11
pondelok;6.4.2020;9:00;22;12;10
pondelok;6.4.2020;10:00;31;13;18
pondelok;6.4.2020;11:00;40;28;12
pondelok;6.4.2020;12:00;45;19;26
pondelok;6.4.2020;13:00;55;29;26
pondelok;6.4.2020;14:00;75;43;32
pondelok;6.4.2020;15:00;127;75;52
pondelok;6.4.2020;16:00;127;70;57
pondelok;6.4.2020;17:00;139;79;60
pondelok;6.4.2020;18:00;128;83;45
pondelok;6.4.2020;19:00;53;29;24
pondelok;6.4.2020;20:00;16;13;3
pondelok;6.4.2020;21:00;8;5;3
pondelok;6.4.2020;22:00;2;1;1
pondelok;6.4.2020;23:00;1;1;0
utorok;7.4.2020;0:00;1;0;1
utorok;7.4.2020;1:00;0;0;0
utorok;7.4.2020;2:00;0;0;0
utorok;7.4.2020;3:00;0;0;0
utorok;7.4.2020;4:00;0;0;0
utorok;7.4.2020;5:00;1;0;1
utorok;7.4.2020;6:00;19;11;8
utorok;7.4.2020;7:00;20;7;13
utorok;7.4.2020;8:00;23;13;10
utorok;7.4.2020;9:00;32;12;20
utorok;7.4.2020;10:00;35;24;11
utorok;7.4.2020;11:00;67;40;27
utorok;7.4.2020;12:00;67;40;27
utorok;7.4.2020;13:00;80;45;35
utorok;7.4.2020;14:00;112;63;49
utorok;7.4.2020;15:00;161;98;63
utorok;7.4.2020;16:00;187;116;71
utorok;7.4.2020;17:00;213;115;98
utorok;7.4.2020;18:00;142;85;57
utorok;7.4.2020;19:00;115;69;46
utorok;7.4.2020;20:00;26;17;9
utorok;7.4.2020;21:00;11;3;8
utorok;7.4.2020;22:00;5;3;2
utorok;7.4.2020;23:00;6;4;2
streda;8.4.2020;0:00;1;1;0
streda;8.4.2020;1:00;1;1;0
streda;8.4.2020;2:00;0;0;0
streda;8.4.2020;3:00;0;0;0
streda;8.4.2020;4:00;0;0;0
streda;8.4.2020;5:00;1;0;1
streda;8.4.2020;6:00;16;7;9
streda;8.4.2020;7:00;19;11;8
streda;8.4.2020;8:00;23;11;12
streda;8.4.2020;9:00;27;18;9
streda;8.4.2020;10:00;45;25;20
streda;8.4.2020;11:00;62;36;26
streda;8.4.2020;12:00;73;37;36
streda;8.4.2020;13:00;85;54;31
streda;8.4.2020;14:00;108;54;54
streda;8.4.2020;15:00;169;88;81
streda;8.4.2020;16:00;205;128;77
streda;8.4.2020;17:00;189;98;91
streda;8.4.2020;18:00;163;97;66
streda;8.4.2020;19:00;87;50;37
streda;8.4.2020;20:00;27;15;12
streda;8.4.2020;21:00;8;6;2
streda;8.4.2020;22:00;0;0;0
streda;8.4.2020;23:00;1;1;0
štvrtok;9.4.2020;0:00;2;0;2
štvrtok;9.4.2020;1:00;0;0;0
štvrtok;9.4.2020;2:00;2;2;0
štvrtok;9.4.2020;3:00;0;0;0
štvrtok;9.4.2020;4:00;0;0;0
štvrtok;9.4.2020;5:00;2;1;1
štvrtok;9.4.2020;6:00;13;8;5
štvrtok;9.4.2020;7:00;18;8;10
štvrtok;9.4.2020;8:00;30;17;13
štvrtok;9.4.2020;9:00;39;18;21
štvrtok;9.4.2020;10:00;63;33;30
štvrtok;9.4.2020;11:00;90;49;41
štvrtok;9.4.2020;12:00;108;53;55
štvrtok;9.4.2020;13:00;162;93;69
štvrtok;9.4.2020;14:00;210;120;90
štvrtok;9.4.2020;15:00;240;147;93
štvrtok;9.4.2020;16:00;276;147;129
štvrtok;9.4.2020;17:00;311;167;144
štvrtok;9.4.2020;18:00;214;131;83
štvrtok;9.4.2020;19:00;84;42;42
štvrtok;9.4.2020;20:00;33;18;15
štvrtok;9.4.2020;21:00;3;2;1
štvrtok;9.4.2020;22:00;0;0;0
štvrtok;9.4.2020;23:00;3;3;0
piatok;10.4.2020;0:00;1;0;1
piatok;10.4.2020;1:00;2;2;0
piatok;10.4.2020;2:00;0;0;0
piatok;10.4.2020;3:00;0;0;0
piatok;10.4.2020;4:00;0;0;0
piatok;10.4.2020;5:00;2;1;1
piatok;10.4.2020;6:00;8;4;4
piatok;10.4.2020;7:00;13;4;9
piatok;10.4.2020;8:00;39;20;19
piatok;10.4.2020;9:00;98;63;35
piatok;10.4.2020;10:00;173;121;52
piatok;10.4.2020;11:00;250;143;107
piatok;10.4.2020;12:00;231;127;104
piatok;10.4.2020;13:00;251;135;116
piatok;10.4.2020;14:00;358;219;139
piatok;10.4.2020;15:00;348;217;131
piatok;10.4.2020;16:00;341;211;130
piatok;10.4.2020;17:00;350;181;169
piatok;10.4.2020;18:00;189;86;103
piatok;10.4.2020;19:00;104;53;51
piatok;10.4.2020;20:00;19;12;7
piatok;10.4.2020;21:00;3;2;1
piatok;10.4.2020;22:00;3;2;1
piatok;10.4.2020;23:00;2;1;1
sobota;11.4.2020;0:00;1;1;0
sobota;11.4.2020;1:00;1;0;1
sobota;11.4.2020;2:00;0;0;0
sobota;11.4.2020;3:00;1;1;0
sobota;11.4.2020;4:00;0;0;0
sobota;11.4.2020;5:00;2;2;0
sobota;11.4.2020;6:00;4;2;2
sobota;11.4.2020;7:00;11;6;5
sobota;11.4.2020;8:00;33;20;13
sobota;11.4.2020;9:00;74;54;20
sobota;11.4.2020;10:00;154;92;62
sobota;11.4.2020;11:00;202;119;83
sobota;11.4.2020;12:00;208;99;109
sobota;11.4.2020;13:00;239;151;88
sobota;11.4.2020;14:00;322;200;122
sobota;11.4.2020;15:00;339;156;183
sobota;11.4.2020;16:00;351;198;153
sobota;11.4.2020;17:00;293;148;145
sobota;11.4.2020;18:00;206;100;106
sobota;11.4.2020;19:00;103;50;53
sobota;11.4.2020;20:00;23;10;13
sobota;11.4.2020;21:00;1;0;1
sobota;11.4.2020;22:00;1;1;0
sobota;11.4.2020;23:00;2;2;0
nede?a;12.4.2020;0:00;2;2;0
nede?a;12.4.2020;1:00;0;0;0
nede?a;12.4.2020;2:00;0;0;0
nede?a;12.4.2020;3:00;0;0;0
nede?a;12.4.2020;4:00;0;0;0
nede?a;12.4.2020;5:00;1;0;1
nede?a;12.4.2020;6:00;4;3;1
nede?a;12.4.2020;7:00;10;5;5
nede?a;12.4.2020;8:00;38;27;11
nede?a;12.4.2020;9:00;92;64;28
nede?a;12.4.2020;10:00;170;116;54
nede?a;12.4.2020;11:00;237;137;100
nede?a;12.4.2020;12:00;257;160;97
nede?a;12.4.2020;13:00;312;192;120
nede?a;12.4.2020;14:00;399;214;185
nede?a;12.4.2020;15:00;475;256;219
nede?a;12.4.2020;16:00;453;221;232
nede?a;12.4.2020;17:00;430;230;200
nede?a;12.4.2020;18:00;290;147;143
nede?a;12.4.2020;19:00;120;66;54
nede?a;12.4.2020;20:00;44;28;16
nede?a;12.4.2020;21:00;13;8;5
nede?a;12.4.2020;22:00;5;5;0
nede?a;12.4.2020;23:00;1;1;0
pondelok;13.4.2020;0:00;3;2;1
pondelok;13.4.2020;1:00;0;0;0
pondelok;13.4.2020;2:00;0;0;0
pondelok;13.4.2020;3:00;0;0;0
pondelok;13.4.2020;4:00;0;0;0
pondelok;13.4.2020;5:00;1;1;0
pondelok;13.4.2020;6:00;6;1;5
pondelok;13.4.2020;7:00;20;10;10
pondelok;13.4.2020;8:00;36;18;18
pondelok;13.4.2020;9:00;117;65;52
pondelok;13.4.2020;10:00;195;126;69
pondelok;13.4.2020;11:00;243;138;105
pondelok;13.4.2020;12:00;219;140;79
pondelok;13.4.2020;13:00;252;142;110
pondelok;13.4.2020;14:00;204;121;83
pondelok;13.4.2020;15:00;238;119;119
pondelok;13.4.2020;16:00;231;137;94
pondelok;13.4.2020;17:00;177;79;98
pondelok;13.4.2020;18:00;102;61;41
pondelok;13.4.2020;19:00;26;17;9
pondelok;13.4.2020;20:00;0;0;0
pondelok;13.4.2020;21:00;1;1;0
pondelok;13.4.2020;22:00;0;0;0
pondelok;13.4.2020;23:00;3;2;1
utorok;14.4.2020;0:00;0;0;0
utorok;14.4.2020;1:00;0;0;0
utorok;14.4.2020;2:00;0;0;0
utorok;14.4.2020;3:00;0;0;0
utorok;14.4.2020;4:00;0;0;0
utorok;14.4.2020;5:00;0;0;0
utorok;14.4.2020;6:00;6;3;3
utorok;14.4.2020;7:00;9;4;5
utorok;14.4.2020;8:00;14;7;7
utorok;14.4.2020;9:00;15;9;6
utorok;14.4.2020;10:00;25;15;10
utorok;14.4.2020;11:00;10;6;4
utorok;14.4.2020;12:00;26;11;15
utorok;14.4.2020;13:00;18;7;11
utorok;14.4.2020;14:00;16;9;7
utorok;14.4.2020;15:00;24;13;11
utorok;14.4.2020;16:00;45;24;21
utorok;14.4.2020;17:00;50;29;21
utorok;14.4.2020;18:00;46;25;21
utorok;14.4.2020;19:00;24;12;12
utorok;14.4.2020;20:00;6;3;3
utorok;14.4.2020;21:00;9;5;4
utorok;14.4.2020;22:00;1;1;0
utorok;14.4.2020;23:00;1;1;0
streda;15.4.2020;0:00;1;0;1
streda;15.4.2020;1:00;0;0;0
streda;15.4.2020;2:00;0;0;0
streda;15.4.2020;3:00;0;0;0
streda;15.4.2020;4:00;0;0;0
streda;15.4.2020;5:00;0;0;0
streda;15.4.2020;6:00;10;5;5
streda;15.4.2020;7:00;22;11;11
streda;15.4.2020;8:00;31;16;15
streda;15.4.2020;9:00;31;13;18
streda;15.4.2020;10:00;23;12;11
streda;15.4.2020;11:00;49;29;20
streda;15.4.2020;12:00;45;25;20
streda;15.4.2020;13:00;52;26;26
streda;15.4.2020;14:00;94;53;41
streda;15.4.2020;15:00;100;48;52
streda;15.4.2020;16:00;220;120;100
streda;15.4.2020;17:00;163;101;62
streda;15.4.2020;18:00;125;68;57
streda;15.4.2020;19:00;76;41;35
streda;15.4.2020;20:00;22;11;11
streda;15.4.2020;21:00;2;1;1
streda;15.4.2020;22:00;3;2;1
streda;15.4.2020;23:00;3;2;1
štvrtok;16.4.2020;0:00;0;0;0
štvrtok;16.4.2020;1:00;0;0;0
štvrtok;16.4.2020;2:00;0;0;0
štvrtok;16.4.2020;3:00;0;0;0
štvrtok;16.4.2020;4:00;0;0;0
štvrtok;16.4.2020;5:00;2;1;1
štvrtok;16.4.2020;6:00;10;5;5
štvrtok;16.4.2020;7:00;32;19;13
štvrtok;16.4.2020;8:00;26;17;9
štvrtok;16.4.2020;9:00;30;15;15
štvrtok;16.4.2020;10:00;51;29;22
štvrtok;16.4.2020;11:00;68;41;27
štvrtok;16.4.2020;12:00;88;47;41
štvrtok;16.4.2020;13:00;133;65;68
štvrtok;16.4.2020;14:00;173;107;66
štvrtok;16.4.2020;15:00;252;175;77
štvrtok;16.4.2020;16:00;297;161;136
štvrtok;16.4.2020;17:00;347;218;129
štvrtok;16.4.2020;18:00;303;157;146
štvrtok;16.4.2020;19:00;189;105;84
štvrtok;16.4.2020;20:00;49;26;23
štvrtok;16.4.2020;21:00;3;2;1
štvrtok;16.4.2020;22:00;8;3;5
štvrtok;16.4.2020;23:00;7;5;2
piatok;17.4.2020;0:00;1;0;1
piatok;17.4.2020;1:00;1;0;1
piatok;17.4.2020;2:00;1;1;0
piatok;17.4.2020;3:00;0;0;0
piatok;17.4.2020;4:00;0;0;0
piatok;17.4.2020;5:00;0;0;0
piatok;17.4.2020;6:00;10;7;3
piatok;17.4.2020;7:00;26;13;13
piatok;17.4.2020;8:00;43;23;20
piatok;17.4.2020;9:00;61;35;26
piatok;17.4.2020;10:00;57;31;26
piatok;17.4.2020;11:00;73;28;45
piatok;17.4.2020;12:00;97;41;56
piatok;17.4.2020;13:00;126;63;63
piatok;17.4.2020;14:00;164;90;74
piatok;17.4.2020;15:00;225;133;92
piatok;17.4.2020;16:00;351;227;124
piatok;17.4.2020;17:00;338;186;152
piatok;17.4.2020;18:00;255;140;115
piatok;17.4.2020;19:00;182;92;90
piatok;17.4.2020;20:00;33;16;17
piatok;17.4.2020;21:00;8;4;4
piatok;17.4.2020;22:00;9;5;4
piatok;17.4.2020;23:00;7;5;2
sobota;18.4.2020;0:00;3;3;0
sobota;18.4.2020;1:00;3;1;2
sobota;18.4.2020;2:00;3;0;3
sobota;18.4.2020;3:00;5;2;3
sobota;18.4.2020;4:00;0;0;0
sobota;18.4.2020;5:00;2;0;2
sobota;18.4.2020;6:00;3;2;1
sobota;18.4.2020;7:00;16;10;6
sobota;18.4.2020;8:00;39;23;16
sobota;18.4.2020;9:00;93;48;45
sobota;18.4.2020;10:00;233;129;104
sobota;18.4.2020;11:00;269;162;107
sobota;18.4.2020;12:00;271;144;127
sobota;18.4.2020;13:00;277;162;115
sobota;18.4.2020;14:00;367;208;159
sobota;18.4.2020;15:00;405;227;178
sobota;18.4.2020;16:00;435;255;180
sobota;18.4.2020;17:00;386;212;174
sobota;18.4.2020;18:00;274;141;133
sobota;18.4.2020;19:00;108;68;40
sobota;18.4.2020;20:00;58;36;22
sobota;18.4.2020;21:00;10;6;4
sobota;18.4.2020;22:00;4;2;2
sobota;18.4.2020;23:00;3;3;0
nede?a;19.4.2020;0:00;3;0;3
nede?a;19.4.2020;1:00;1;1;0
nede?a;19.4.2020;2:00;3;0;3
nede?a;19.4.2020;3:00;0;0;0
nede?a;19.4.2020;4:00;1;0;1
nede?a;19.4.2020;5:00;3;2;1
nede?a;19.4.2020;6:00;5;1;4
nede?a;19.4.2020;7:00;5;3;2
nede?a;19.4.2020;8:00;11;7;4
nede?a;19.4.2020;9:00;25;20;5
nede?a;19.4.2020;10:00;35;22;13
nede?a;19.4.2020;11:00;42;18;24
nede?a;19.4.2020;12:00;32;21;11
nede?a;19.4.2020;13:00;52;32;20
nede?a;19.4.2020;14:00;104;60;44
nede?a;19.4.2020;15:00;130;59;71
nede?a;19.4.2020;16:00;188;116;72
nede?a;19.4.2020;17:00;209;110;99
nede?a;19.4.2020;18:00;134;62;72
nede?a;19.4.2020;19:00;67;41;26
nede?a;19.4.2020;20:00;21;14;7
nede?a;19.4.2020;21:00;4;3;1
nede?a;19.4.2020;22:00;0;0;0
nede?a;19.4.2020;23:00;1;1;0
pondelok;20.4.2020;0:00;1;0;1
pondelok;20.4.2020;1:00;0;0;0
pondelok;20.4.2020;2:00;0;0;0
pondelok;20.4.2020;3:00;0;0;0
pondelok;20.4.2020;4:00;0;0;0
pondelok;20.4.2020;5:00;4;2;2
pondelok;20.4.2020;6:00;13;9;4
pondelok;20.4.2020;7:00;25;13;12
pondelok;20.4.2020;8:00;38;23;15
pondelok;20.4.2020;9:00;26;15;11
pondelok;20.4.2020;10:00;32;16;16
pondelok;20.4.2020;11:00;43;24;19
pondelok;20.4.2020;12:00;56;23;33
pondelok;20.4.2020;13:00;71;32;39
pondelok;20.4.2020;14:00;121;59;62
pondelok;20.4.2020;15:00;164;97;67
pondelok;20.4.2020;16:00;220;116;104
pondelok;20.4.2020;17:00;247;152;95
pondelok;20.4.2020;18:00;227;121;106
pondelok;20.4.2020;19:00;135;82;53
pondelok;20.4.2020;20:00;50;36;14
pondelok;20.4.2020;21:00;14;9;5
pondelok;20.4.2020;22:00;2;1;1
pondelok;20.4.2020;23:00;1;1;0
utorok;21.4.2020;0:00;1;0;1
utorok;21.4.2020;1:00;0;0;0
utorok;21.4.2020;2:00;0;0;0
utorok;21.4.2020;3:00;0;0;0
utorok;21.4.2020;4:00;1;0;1
utorok;21.4.2020;5:00;2;0;2
utorok;21.4.2020;6:00;15;9;6
utorok;21.4.2020;7:00;36;21;15
utorok;21.4.2020;8:00;51;24;27
utorok;21.4.2020;9:00;33;22;11
utorok;21.4.2020;10:00;64;36;28
utorok;21.4.2020;11:00;87;50;37
utorok;21.4.2020;12:00;72;34;38
utorok;21.4.2020;13:00;123;72;51
utorok;21.4.2020;14:00;146;79;67
utorok;21.4.2020;15:00;190;115;75
utorok;21.4.2020;16:00;267;151;116
utorok;21.4.2020;17:00;330;189;141
utorok;21.4.2020;18:00;330;188;142
utorok;21.4.2020;19:00;171;101;70
utorok;21.4.2020;20:00;52;30;22
utorok;21.4.2020;21:00;13;6;7
utorok;21.4.2020;22:00;9;6;3
utorok;21.4.2020;23:00;2;1;1
streda;22.4.2020;0:00;1;0;1
streda;22.4.2020;1:00;1;0;1
streda;22.4.2020;2:00;0;0;0
streda;22.4.2020;3:00;2;0;2
streda;22.4.2020;4:00;1;0;1
streda;22.4.2020;5:00;4;1;3
streda;22.4.2020;6:00;20;12;8
streda;22.4.2020;7:00;29;15;14
streda;22.4.2020;8:00;59;34;25
streda;22.4.2020;9:00;39;25;14
streda;22.4.2020;10:00;54;27;27
streda;22.4.2020;11:00;92;53;39
streda;22.4.2020;12:00;82;42;40
streda;22.4.2020;13:00;104;50;54
streda;22.4.2020;14:00;143;69;74
streda;22.4.2020;15:00;230;149;81
streda;22.4.2020;16:00;262;132;130
streda;22.4.2020;17:00;361;193;168
streda;22.4.2020;18:00;349;203;146
streda;22.4.2020;19:00;194;107;87
streda;22.4.2020;20:00;80;57;23
streda;22.4.2020;21:00;7;4;3
streda;22.4.2020;22:00;7;3;4
streda;22.4.2020;23:00;2;2;0
štvrtok;23.4.2020;0:00;1;1;0
štvrtok;23.4.2020;1:00;1;1;0
štvrtok;23.4.2020;2:00;0;0;0
štvrtok;23.4.2020;3:00;0;0;0
štvrtok;23.4.2020;4:00;0;0;0
štvrtok;23.4.2020;5:00;6;4;2
štvrtok;23.4.2020;6:00;15;7;8
štvrtok;23.4.2020;7:00;37;23;14
štvrtok;23.4.2020;8:00;37;22;15
štvrtok;23.4.2020;9:00;56;26;30
štvrtok;23.4.2020;10:00;72;33;39
štvrtok;23.4.2020;11:00;105;55;50
štvrtok;23.4.2020;12:00;90;44;46
štvrtok;23.4.2020;13:00;112;56;56
štvrtok;23.4.2020;14:00;197;104;93
štvrtok;23.4.2020;15:00;239;152;87
štvrtok;23.4.2020;16:00;319;175;144
štvrtok;23.4.2020;17:00;370;229;141
štvrtok;23.4.2020;18:00;410;250;160
štvrtok;23.4.2020;19:00;173;85;88
štvrtok;23.4.2020;20:00;56;28;28
štvrtok;23.4.2020;21:00;20;14;6
štvrtok;23.4.2020;22:00;3;0;3
štvrtok;23.4.2020;23:00;4;4;0
piatok;24.4.2020;0:00;2;1;1
piatok;24.4.2020;1:00;1;0;1
piatok;24.4.2020;2:00;0;0;0
piatok;24.4.2020;3:00;0;0;0
piatok;24.4.2020;4:00;0;0;0
piatok;24.4.2020;5:00;6;1;5
piatok;24.4.2020;6:00;18;10;8
piatok;24.4.2020;7:00;36;21;15
piatok;24.4.2020;8:00;39;20;19
piatok;24.4.2020;9:00;44;22;22
piatok;24.4.2020;10:00;68;36;32
piatok;24.4.2020;11:00;111;59;52
piatok;24.4.2020;12:00;112;42;70
piatok;24.4.2020;13:00;129;72;57
piatok;24.4.2020;14:00;210;115;95
piatok;24.4.2020;15:00;250;145;105
piatok;24.4.2020;16:00;331;196;135
piatok;24.4.2020;17:00;316;178;138
piatok;24.4.2020;18:00;283;175;108
piatok;24.4.2020;19:00;153;82;71
piatok;24.4.2020;20:00;67;36;31
piatok;24.4.2020;21:00;26;14;12
piatok;24.4.2020;22:00;9;6;3
piatok;24.4.2020;23:00;10;8;2
sobota;25.4.2020;0:00;1;1;0
sobota;25.4.2020;1:00;1;0;1
sobota;25.4.2020;2:00;0;0;0
sobota;25.4.2020;3:00;0;0;0
sobota;25.4.2020;4:00;0;0;0
sobota;25.4.2020;5:00;2;1;1
sobota;25.4.2020;6:00;4;2;2
sobota;25.4.2020;7:00;20;16;4
sobota;25.4.2020;8:00;51;30;21
sobota;25.4.2020;9:00;87;53;34
sobota;25.4.2020;10:00;191;131;60
sobota;25.4.2020;11:00;189;109;80
sobota;25.4.2020;12:00;172;81;91
sobota;25.4.2020;13:00;134;72;62
sobota;25.4.2020;14:00;161;72;89
sobota;25.4.2020;15:00;142;97;45
sobota;25.4.2020;16:00;132;63;69
sobota;25.4.2020;17:00;150;80;70
sobota;25.4.2020;18:00;121;70;51
sobota;25.4.2020;19:00;69;32;37
sobota;25.4.2020;20:00;30;13;17
sobota;25.4.2020;21:00;14;8;6
sobota;25.4.2020;22:00;7;7;0
sobota;25.4.2020;23:00;6;4;2
nede?a;26.4.2020;0:00;3;1;2
nede?a;26.4.2020;1:00;0;0;0
nede?a;26.4.2020;2:00;0;0;0
nede?a;26.4.2020;3:00;0;0;0
nede?a;26.4.2020;4:00;0;0;0
nede?a;26.4.2020;5:00;1;1;0
nede?a;26.4.2020;6:00;2;2;0
nede?a;26.4.2020;7:00;14;8;6
nede?a;26.4.2020;8:00;42;28;14
nede?a;26.4.2020;9:00;125;80;45
nede?a;26.4.2020;10:00;218;147;71
nede?a;26.4.2020;11:00;268;143;125
nede?a;26.4.2020;12:00;202;110;92
nede?a;26.4.2020;13:00;346;197;149
nede?a;26.4.2020;14:00;376;185;191
nede?a;26.4.2020;15:00;422;237;185
nede?a;26.4.2020;16:00;494;269;225
nede?a;26.4.2020;17:00;411;220;191
nede?a;26.4.2020;18:00;310;158;152
nede?a;26.4.2020;19:00;184;109;75
nede?a;26.4.2020;20:00;29;21;8
nede?a;26.4.2020;21:00;10;6;4
nede?a;26.4.2020;22:00;4;2;2
nede?a;26.4.2020;23:00;7;6;1
pondelok;27.4.2020;0:00;3;3;0
pondelok;27.4.2020;1:00;1;0;1
pondelok;27.4.2020;2:00;0;0;0
pondelok;27.4.2020;3:00;0;0;0
pondelok;27.4.2020;4:00;0;0;0
pondelok;27.4.2020;5:00;3;2;1
pondelok;27.4.2020;6:00;17;11;6
pondelok;27.4.2020;7:00;36;19;17
pondelok;27.4.2020;8:00;31;17;14
pondelok;27.4.2020;9:00;31;14;17
pondelok;27.4.2020;10:00;33;21;12
pondelok;27.4.2020;11:00;48;20;28
pondelok;27.4.2020;12:00;54;28;26
pondelok;27.4.2020;13:00;66;38;28
pondelok;27.4.2020;14:00;97;46;51
pondelok;27.4.2020;15:00;134;69;65
pondelok;27.4.2020;16:00;194;105;89
pondelok;27.4.2020;17:00;237;131;106
pondelok;27.4.2020;18:00;195;116;79
pondelok;27.4.2020;19:00;137;92;45
pondelok;27.4.2020;20:00;46;23;23
pondelok;27.4.2020;21:00;17;12;5
pondelok;27.4.2020;22:00;12;5;7
pondelok;27.4.2020;23:00;4;4;0
utorok;28.4.2020;0:00;5;4;1
utorok;28.4.2020;1:00;4;0;4
utorok;28.4.2020;2:00;0;0;0
utorok;28.4.2020;3:00;1;0;1
utorok;28.4.2020;4:00;0;0;0
utorok;28.4.2020;5:00;5;2;3
utorok;28.4.2020;6:00;27;16;11
utorok;28.4.2020;7:00;46;26;20
utorok;28.4.2020;8:00;46;20;26
utorok;28.4.2020;9:00;61;31;30
utorok;28.4.2020;10:00;69;36;33
utorok;28.4.2020;11:00;110;63;47
utorok;28.4.2020;12:00;112;60;52
utorok;28.4.2020;13:00;132;67;65
utorok;28.4.2020;14:00;175;77;98
utorok;28.4.2020;15:00;272;145;127
utorok;28.4.2020;16:00;443;238;205
utorok;28.4.2020;17:00;441;268;173
utorok;28.4.2020;18:00;409;231;178
utorok;28.4.2020;19:00;252;154;98
utorok;28.4.2020;20:00;87;53;34
utorok;28.4.2020;21:00;32;18;14
utorok;28.4.2020;22:00;7;4;3
utorok;28.4.2020;23:00;3;1;2
streda;29.4.2020;0:00;1;1;0
streda;29.4.2020;1:00;0;0;0
streda;29.4.2020;2:00;0;0;0
streda;29.4.2020;3:00;0;0;0
streda;29.4.2020;4:00;0;0;0
streda;29.4.2020;5:00;4;3;1
streda;29.4.2020;6:00;23;16;7
streda;29.4.2020;7:00;31;18;13
streda;29.4.2020;8:00;40;22;18
streda;29.4.2020;9:00;38;22;16
streda;29.4.2020;10:00;28;12;16
streda;29.4.2020;11:00;30;20;10
streda;29.4.2020;12:00;30;18;12
streda;29.4.2020;13:00;25;9;16
streda;29.4.2020;14:00;24;11;13
streda;29.4.2020;15:00;42;18;24
streda;29.4.2020;16:00;51;27;24
streda;29.4.2020;17:00;109;59;50
streda;29.4.2020;18:00;107;59;48
streda;29.4.2020;19:00;59;33;26
streda;29.4.2020;20:00;19;10;9
streda;29.4.2020;21:00;2;0;2
streda;29.4.2020;22:00;1;1;0
streda;29.4.2020;23:00;1;0;1
štvrtok;30.4.2020;0:00;2;1;1
štvrtok;30.4.2020;1:00;0;0;0
štvrtok;30.4.2020;2:00;0;0;0
štvrtok;30.4.2020;3:00;0;0;0
štvrtok;30.4.2020;4:00;0;0;0
štvrtok;30.4.2020;5:00;2;1;1
štvrtok;30.4.2020;6:00;19;12;7
štvrtok;30.4.2020;7:00;28;15;13
štvrtok;30.4.2020;8:00;38;18;20
štvrtok;30.4.2020;9:00;65;38;27
štvrtok;30.4.2020;10:00;82;40;42
štvrtok;30.4.2020;11:00;79;37;42
štvrtok;30.4.2020;12:00;95;45;50
štvrtok;30.4.2020;13:00;111;51;60
štvrtok;30.4.2020;14:00;189;103;86
štvrtok;30.4.2020;15:00;223;123;100
štvrtok;30.4.2020;16:00;348;202;146
štvrtok;30.4.2020;17:00;386;229;157
štvrtok;30.4.2020;18:00;337;199;138
štvrtok;30.4.2020;19:00;242;124;118
štvrtok;30.4.2020;20:00;66;47;19
štvrtok;30.4.2020;21:00;28;18;10
štvrtok;30.4.2020;22:00;5;1;4
štvrtok;30.4.2020;23:00;10;4;6
piatok;1.5.2020;0:00;9;7;2
piatok;1.5.2020;1:00;4;4;0
piatok;1.5.2020;2:00;0;0;0
piatok;1.5.2020;3:00;3;3;0
piatok;1.5.2020;4:00;0;0;0
piatok;1.5.2020;5:00;0;0;0
piatok;1.5.2020;6:00;5;3;2
piatok;1.5.2020;7:00;12;10;2
piatok;1.5.2020;8:00;3;2;1
piatok;1.5.2020;9:00;16;13;3
piatok;1.5.2020;10:00;45;25;20
piatok;1.5.2020;11:00;70;44;26
piatok;1.5.2020;12:00;108;61;47
piatok;1.5.2020;13:00;148;76;72
piatok;1.5.2020;14:00;249;131;118
piatok;1.5.2020;15:00;333;181;152
piatok;1.5.2020;16:00;322;155;167
piatok;1.5.2020;17:00;320;190;130
piatok;1.5.2020;18:00;258;122;136
piatok;1.5.2020;19:00;140;80;60
piatok;1.5.2020;20:00;45;24;21
piatok;1.5.2020;21:00;27;17;10
piatok;1.5.2020;22:00;10;7;3
piatok;1.5.2020;23:00;5;4;1
sobota;2.5.2020;0:00;5;4;1
sobota;2.5.2020;1:00;1;0;1
sobota;2.5.2020;2:00;2;2;0
sobota;2.5.2020;3:00;0;0;0
sobota;2.5.2020;4:00;1;0;1
sobota;2.5.2020;5:00;1;0;1
sobota;2.5.2020;6:00;7;4;3
sobota;2.5.2020;7:00;14;11;3
sobota;2.5.2020;8:00;53;34;19
sobota;2.5.2020;9:00;89;55;34
sobota;2.5.2020;10:00;170;95;75
sobota;2.5.2020;11:00;192;91;101
sobota;2.5.2020;12:00;213;128;85
sobota;2.5.2020;13:00;211;111;100
sobota;2.5.2020;14:00;252;144;108
sobota;2.5.2020;15:00;295;156;139
sobota;2.5.2020;16:00;268;138;130
sobota;2.5.2020;17:00;256;139;117
sobota;2.5.2020;18:00;162;92;70
sobota;2.5.2020;19:00;130;73;57
sobota;2.5.2020;20:00;55;31;24
sobota;2.5.2020;21:00;11;5;6
sobota;2.5.2020;22:00;1;1;0
sobota;2.5.2020;23:00;1;0;1
nede?a;3.5.2020;0:00;2;2;0
nede?a;3.5.2020;1:00;2;1;1
nede?a;3.5.2020;2:00;0;0;0
nede?a;3.5.2020;3:00;0;0;0
nede?a;3.5.2020;4:00;0;0;0
nede?a;3.5.2020;5:00;1;1;0
nede?a;3.5.2020;6:00;6;5;1
nede?a;3.5.2020;7:00;20;13;7
nede?a;3.5.2020;8:00;37;31;6
nede?a;3.5.2020;9:00;33;20;13
nede?a;3.5.2020;10:00;78;53;25
nede?a;3.5.2020;11:00;78;36;42
nede?a;3.5.2020;12:00;67;35;32
nede?a;3.5.2020;13:00;54;32;22
nede?a;3.5.2020;14:00;83;53;30
nede?a;3.5.2020;15:00;118;64;54
nede?a;3.5.2020;16:00;165;90;75
nede?a;3.5.2020;17:00;127;70;57
nede?a;3.5.2020;18:00;115;55;60
nede?a;3.5.2020;19:00;72;46;26
nede?a;3.5.2020;20:00;32;17;15
nede?a;3.5.2020;21:00;14;7;7
nede?a;3.5.2020;22:00;5;2;3
nede?a;3.5.2020;23:00;2;2;0
pondelok;4.5.2020;0:00;0;0;0
pondelok;4.5.2020;1:00;0;0;0
pondelok;4.5.2020;2:00;0;0;0
pondelok;4.5.2020;3:00;0;0;0
pondelok;4.5.2020;4:00;1;0;1
pondelok;4.5.2020;5:00;5;2;3
pondelok;4.5.2020;6:00;25;18;7
pondelok;4.5.2020;7:00;40;21;19
pondelok;4.5.2020;8:00;41;20;21
pondelok;4.5.2020;9:00;54;30;24
pondelok;4.5.2020;10:00;57;28;29
pondelok;4.5.2020;11:00;85;46;39
pondelok;4.5.2020;12:00;83;49;34
pondelok;4.5.2020;13:00;117;59;58
pondelok;4.5.2020;14:00;127;55;72
pondelok;4.5.2020;15:00;190;111;79
pondelok;4.5.2020;16:00;262;124;138
pondelok;4.5.2020;17:00;316;189;127
pondelok;4.5.2020;18:00;331;194;137
pondelok;4.5.2020;19:00;202;128;74
pondelok;4.5.2020;20:00;75;48;27
pondelok;4.5.2020;21:00;8;6;2
pondelok;4.5.2020;22:00;5;4;1
pondelok;4.5.2020;23:00;6;6;0
utorok;5.5.2020;0:00;0;0;0
utorok;5.5.2020;1:00;1;1;0
utorok;5.5.2020;2:00;0;0;0
utorok;5.5.2020;3:00;0;0;0
utorok;5.5.2020;4:00;1;0;1
utorok;5.5.2020;5:00;2;1;1
utorok;5.5.2020;6:00;18;11;7
utorok;5.5.2020;7:00;27;18;9
utorok;5.5.2020;8:00;28;11;17
utorok;5.5.2020;9:00;26;13;13
utorok;5.5.2020;10:00;30;20;10
utorok;5.5.2020;11:00;27;9;18
utorok;5.5.2020;12:00;31;15;16
utorok;5.5.2020;13:00;53;26;27
utorok;5.5.2020;14:00;77;38;39
utorok;5.5.2020;15:00;122;70;52
utorok;5.5.2020;16:00;158;76;82
utorok;5.5.2020;17:00;204;108;96
utorok;5.5.2020;18:00;240;141;99
utorok;5.5.2020;19:00;141;73;68
utorok;5.5.2020;20:00;62;35;27
utorok;5.5.2020;21:00;7;5;2
utorok;5.5.2020;22:00;7;4;3
utorok;5.5.2020;23:00;0;0;0
streda;6.5.2020;0:00;2;1;1
streda;6.5.2020;1:00;1;1;0
streda;6.5.2020;2:00;0;0;0
streda;6.5.2020;3:00;0;0;0
streda;6.5.2020;4:00;0;0;0
streda;6.5.2020;5:00;5;3;2
streda;6.5.2020;6:00;21;11;10
streda;6.5.2020;7:00;32;23;9
streda;6.5.2020;8:00;39;18;21
streda;6.5.2020;9:00;33;17;16
streda;6.5.2020;10:00;21;11;10
streda;6.5.2020;11:00;32;17;15
streda;6.5.2020;12:00;25;17;8
streda;6.5.2020;13:00;35;18;17
streda;6.5.2020;14:00;38;21;17
streda;6.5.2020;15:00;54;28;26
streda;6.5.2020;16:00;65;27;38
streda;6.5.2020;17:00;97;53;44
streda;6.5.2020;18:00;103;57;46
streda;6.5.2020;19:00;64;37;27
streda;6.5.2020;20:00;27;16;11
streda;6.5.2020;21:00;6;4;2
streda;6.5.2020;22:00;0;0;0
streda;6.5.2020;23:00;3;1;2
štvrtok;7.5.2020;0:00;0;0;0
štvrtok;7.5.2020;1:00;0;0;0
štvrtok;7.5.2020;2:00;0;0;0
štvrtok;7.5.2020;3:00;0;0;0
štvrtok;7.5.2020;4:00;0;0;0
štvrtok;7.5.2020;5:00;5;2;3
štvrtok;7.5.2020;6:00;23;14;9
štvrtok;7.5.2020;7:00;22;16;6
štvrtok;7.5.2020;8:00;42;19;23
štvrtok;7.5.2020;9:00;32;17;15
štvrtok;7.5.2020;10:00;48;31;17
štvrtok;7.5.2020;11:00;40;23;17
štvrtok;7.5.2020;12:00;58;28;30
štvrtok;7.5.2020;13:00;51;28;23
štvrtok;7.5.2020;14:00;94;48;46
štvrtok;7.5.2020;15:00;123;65;58
štvrtok;7.5.2020;16:00;166;86;80
štvrtok;7.5.2020;17:00;178;92;86
štvrtok;7.5.2020;18:00;207;120;87
štvrtok;7.5.2020;19:00;112;63;49
štvrtok;7.5.2020;20:00;49;32;17
štvrtok;7.5.2020;21:00;12;4;8
štvrtok;7.5.2020;22:00;17;6;11
štvrtok;7.5.2020;23:00;1;0;1
piatok;8.5.2020;0:00;5;5;0
piatok;8.5.2020;1:00;1;0;1
piatok;8.5.2020;2:00;0;0;0
piatok;8.5.2020;3:00;1;1;0
piatok;8.5.2020;4:00;1;0;1
piatok;8.5.2020;5:00;0;0;0
piatok;8.5.2020;6:00;9;7;2
piatok;8.5.2020;7:00;34;27;7
piatok;8.5.2020;8:00;42;21;21
piatok;8.5.2020;9:00;85;49;36
piatok;8.5.2020;10:00;198;117;81
piatok;8.5.2020;11:00;214;126;88
piatok;8.5.2020;12:00;238;131;107
piatok;8.5.2020;13:00;261;139;122
piatok;8.5.2020;14:00;368;196;172
piatok;8.5.2020;15:00;366;194;172
piatok;8.5.2020;16:00;462;266;196
piatok;8.5.2020;17:00;400;239;161
piatok;8.5.2020;18:00;263;152;111
piatok;8.5.2020;19:00;175;115;60
piatok;8.5.2020;20:00;78;41;37
piatok;8.5.2020;21:00;24;15;9
piatok;8.5.2020;22:00;6;3;3
piatok;8.5.2020;23:00;2;1;1
sobota;9.5.2020;0:00;2;2;0
sobota;9.5.2020;1:00;0;0;0
sobota;9.5.2020;2:00;0;0;0
sobota;9.5.2020;3:00;1;0;1
sobota;9.5.2020;4:00;0;0;0
sobota;9.5.2020;5:00;5;0;5
sobota;9.5.2020;6:00;8;5;3
sobota;9.5.2020;7:00;17;7;10
sobota;9.5.2020;8:00;32;17;15
sobota;9.5.2020;9:00;94;52;42
sobota;9.5.2020;10:00;139;74;65
sobota;9.5.2020;11:00;172;98;74
sobota;9.5.2020;12:00;187;90;97
sobota;9.5.2020;13:00;232;136;96
sobota;9.5.2020;14:00;289;159;130
sobota;9.5.2020;15:00;320;202;118
sobota;9.5.2020;16:00;415;228;187
sobota;9.5.2020;17:00;320;180;140
sobota;9.5.2020;18:00;197;110;87
sobota;9.5.2020;19:00;113;60;53
sobota;9.5.2020;20:00;68;35;33
sobota;9.5.2020;21:00;13;6;7
sobota;9.5.2020;22:00;11;5;6
sobota;9.5.2020;23:00;9;5;4
nede?a;10.5.2020;0:00;5;2;3
nede?a;10.5.2020;1:00;4;3;1
nede?a;10.5.2020;2:00;0;0;0
nede?a;10.5.2020;3:00;1;0;1
nede?a;10.5.2020;4:00;0;0;0
nede?a;10.5.2020;5:00;1;0;1
nede?a;10.5.2020;6:00;6;4;2
nede?a;10.5.2020;7:00;21;16;5
nede?a;10.5.2020;8:00;37;17;20
nede?a;10.5.2020;9:00;100;47;53
nede?a;10.5.2020;10:00;213;128;85
nede?a;10.5.2020;11:00;243;137;106
nede?a;10.5.2020;12:00;225;124;101
nede?a;10.5.2020;13:00;218;134;84
nede?a;10.5.2020;14:00;306;179;127
nede?a;10.5.2020;15:00;273;157;116
nede?a;10.5.2020;16:00;210;116;94
nede?a;10.5.2020;17:00;221;127;94
nede?a;10.5.2020;18:00;188;106;82
nede?a;10.5.2020;19:00;126;77;49
nede?a;10.5.2020;20:00;52;33;19
nede?a;10.5.2020;21:00;23;15;8
nede?a;10.5.2020;22:00;4;0;4
nede?a;10.5.2020;23:00;5;3;2
pondelok;11.5.2020;0:00;1;1;0
pondelok;11.5.2020;1:00;0;0;0
pondelok;11.5.2020;2:00;0;0;0
pondelok;11.5.2020;3:00;0;0;0
pondelok;11.5.2020;4:00;1;0;1
pondelok;11.5.2020;5:00;8;5;3
pondelok;11.5.2020;6:00;27;17;10
pondelok;11.5.2020;7:00;27;15;12
pondelok;11.5.2020;8:00;47;27;20
pondelok;11.5.2020;9:00;39;20;19
pondelok;11.5.2020;10:00;43;26;17
pondelok;11.5.2020;11:00;44;27;17
pondelok;11.5.2020;12:00;52;33;19
pondelok;11.5.2020;13:00;35;23;12
pondelok;11.5.2020;14:00;50;23;27
pondelok;11.5.2020;15:00;73;34;39
pondelok;11.5.2020;16:00;98;48;50
pondelok;11.5.2020;17:00;99;51;48
pondelok;11.5.2020;18:00;102;66;36
pondelok;11.5.2020;19:00;97;60;37
pondelok;11.5.2020;20:00;33;22;11
pondelok;11.5.2020;21:00;14;9;5
pondelok;11.5.2020;22:00;1;0;1
pondelok;11.5.2020;23:00;0;0;0
utorok;12.5.2020;0:00;2;1;1
utorok;12.5.2020;1:00;1;0;1
utorok;12.5.2020;2:00;0;0;0
utorok;12.5.2020;3:00;0;0;0
utorok;12.5.2020;4:00;0;0;0
utorok;12.5.2020;5:00;2;1;1
utorok;12.5.2020;6:00;9;5;4
utorok;12.5.2020;7:00;10;5;5
utorok;12.5.2020;8:00;22;10;12
utorok;12.5.2020;9:00;15;8;7
utorok;12.5.2020;10:00;12;10;2
utorok;12.5.2020;11:00;26;8;18
utorok;12.5.2020;12:00;18;10;8
utorok;12.5.2020;13:00;24;17;7
utorok;12.5.2020;14:00;28;11;17
utorok;12.5.2020;15:00;74;37;37
utorok;12.5.2020;16:00;100;57;43
utorok;12.5.2020;17:00;130;61;69
utorok;12.5.2020;18:00;146;88;58
utorok;12.5.2020;19:00;105;59;46
utorok;12.5.2020;20:00;69;36;33
utorok;12.5.2020;21:00;13;3;10
utorok;12.5.2020;22:00;5;5;0
utorok;12.5.2020;23:00;1;1;0
streda;13.5.2020;0:00;1;1;0
streda;13.5.2020;1:00;0;0;0
streda;13.5.2020;2:00;0;0;0
streda;13.5.2020;3:00;0;0;0
streda;13.5.2020;4:00;0;0;0
streda;13.5.2020;5:00;4;3;1
streda;13.5.2020;6:00;22;11;11
streda;13.5.2020;7:00;29;20;9
streda;13.5.2020;8:00;37;17;20
streda;13.5.2020;9:00;18;8;10
streda;13.5.2020;10:00;20;7;13
streda;13.5.2020;11:00;33;17;16
streda;13.5.2020;12:00;30;14;16
streda;13.5.2020;13:00;29;13;16
streda;13.5.2020;14:00;60;33;27
streda;13.5.2020;15:00;81;39;42
streda;13.5.2020;16:00;42;25;17
streda;13.5.2020;17:00;33;17;16
streda;13.5.2020;18:00;22;17;5
streda;13.5.2020;19:00;12;7;5
streda;13.5.2020;20:00;5;3;2
streda;13.5.2020;21:00;1;1;0
streda;13.5.2020;22:00;4;2;2
streda;13.5.2020;23:00;1;1;0
štvrtok;14.5.2020;0:00;3;1;2
štvrtok;14.5.2020;1:00;0;0;0
štvrtok;14.5.2020;2:00;0;0;0
štvrtok;14.5.2020;3:00;0;0;0
štvrtok;14.5.2020;4:00;0;0;0
štvrtok;14.5.2020;5:00;6;2;4
štvrtok;14.5.2020;6:00;23;13;10
štvrtok;14.5.2020;7:00;17;11;6
štvrtok;14.5.2020;8:00;23;13;10
štvrtok;14.5.2020;9:00;21;10;11
štvrtok;14.5.2020;10:00;22;15;7
štvrtok;14.5.2020;11:00;18;11;7
štvrtok;14.5.2020;12:00;33;18;15
štvrtok;14.5.2020;13:00;54;28;26
štvrtok;14.5.2020;14:00;54;25;29
štvrtok;14.5.2020;15:00;85;45;40
štvrtok;14.5.2020;16:00;137;63;74
štvrtok;14.5.2020;17:00;168;77;91
štvrtok;14.5.2020;18:00;235;140;95
štvrtok;14.5.2020;19:00;133;89;44
štvrtok;14.5.2020;20:00;64;38;26
štvrtok;14.5.2020;21:00;23;14;9
štvrtok;14.5.2020;22:00;2;0;2
štvrtok;14.5.2020;23:00;5;4;1
piatok;15.5.2020;0:00;1;0;1
piatok;15.5.2020;1:00;1;0;1
piatok;15.5.2020;2:00;0;0;0
piatok;15.5.2020;3:00;0;0;0
piatok;15.5.2020;4:00;0;0;0
piatok;15.5.2020;5:00;0;0;0
piatok;15.5.2020;6:00;2;2;0
piatok;15.5.2020;7:00;3;1;2
piatok;15.5.2020;8:00;12;6;6
piatok;15.5.2020;9:00;7;4;3
piatok;15.5.2020;10:00;3;1;2
piatok;15.5.2020;11:00;3;2;1
piatok;15.5.2020;12:00;0;0;0
piatok;15.5.2020;13:00;3;2;1
piatok;15.5.2020;14:00;2;1;1
piatok;15.5.2020;15:00;7;2;5
piatok;15.5.2020;16:00;4;2;2
piatok;15.5.2020;17:00;17;9;8
piatok;15.5.2020;18:00;32;15;17
piatok;15.5.2020;19:00;34;16;18
piatok;15.5.2020;20:00;23;15;8
piatok;15.5.2020;21:00;12;7;5
piatok;15.5.2020;22:00;2;1;1
piatok;15.5.2020;23:00;2;2;0
sobota;16.5.2020;0:00;2;1;1
sobota;16.5.2020;1:00;0;0;0
sobota;16.5.2020;2:00;0;0;0
sobota;16.5.2020;3:00;0;0;0
sobota;16.5.2020;4:00;0;0;0
sobota;16.5.2020;5:00;2;1;1
sobota;16.5.2020;6:00;7;5;2
sobota;16.5.2020;7:00;10;6;4
sobota;16.5.2020;8:00;38;16;22
sobota;16.5.2020;9:00;85;48;37
sobota;16.5.2020;10:00;174;104;70
sobota;16.5.2020;11:00;183;109;74
sobota;16.5.2020;12:00;192;104;88
sobota;16.5.2020;13:00;260;143;117
sobota;16.5.2020;14:00;324;188;136
sobota;16.5.2020;15:00;346;186;160
sobota;16.5.2020;16:00;375;216;159
sobota;16.5.2020;17:00;330;194;136
sobota;16.5.2020;18:00;247;129;118
sobota;16.5.2020;19:00;144;78;66
sobota;16.5.2020;20:00;67;32;35
sobota;16.5.2020;21:00;18;14;4
sobota;16.5.2020;22:00;11;8;3
sobota;16.5.2020;23:00;7;5;2
nede?a;17.5.2020;0:00;2;1;1
nede?a;17.5.2020;1:00;1;1;0
nede?a;17.5.2020;2:00;2;2;0
nede?a;17.5.2020;3:00;0;0;0
nede?a;17.5.2020;4:00;1;0;1
nede?a;17.5.2020;5:00;0;0;0
nede?a;17.5.2020;6:00;5;1;4
nede?a;17.5.2020;7:00;17;11;6
nede?a;17.5.2020;8:00;24;18;6
nede?a;17.5.2020;9:00;63;39;24
nede?a;17.5.2020;10:00;125;65;60
nede?a;17.5.2020;11:00;169;116;53
nede?a;17.5.2020;12:00;181;105;76
nede?a;17.5.2020;13:00;255;140;115
nede?a;17.5.2020;14:00;418;227;191
nede?a;17.5.2020;15:00;546;324;222
nede?a;17.5.2020;16:00;547;312;235
nede?a;17.5.2020;17:00;502;257;245
nede?a;17.5.2020;18:00;273;151;122
nede?a;17.5.2020;19:00;192;116;76
nede?a;17.5.2020;20:00;70;51;19
nede?a;17.5.2020;21:00;30;14;16
nede?a;17.5.2020;22:00;3;0;3
nede?a;17.5.2020;23:00;4;1;3
pondelok;18.5.2020;0:00;2;2;0
pondelok;18.5.2020;1:00;0;0;0
pondelok;18.5.2020;2:00;0;0;0
pondelok;18.5.2020;3:00;0;0;0
pondelok;18.5.2020;4:00;0;0;0
pondelok;18.5.2020;5:00;6;2;4
pondelok;18.5.2020;6:00;23;10;13
pondelok;18.5.2020;7:00;67;47;20
pondelok;18.5.2020;8:00;63;25;38
pondelok;18.5.2020;9:00;53;21;32
pondelok;18.5.2020;10:00;61;28;33
pondelok;18.5.2020;11:00;75;39;36
pondelok;18.5.2020;12:00;71;32;39
pondelok;18.5.2020;13:00;93;51;42
pondelok;18.5.2020;14:00;158;76;82
pondelok;18.5.2020;15:00;203;106;97
pondelok;18.5.2020;16:00;334;178;156
pondelok;18.5.2020;17:00;353;200;153
pondelok;18.5.2020;18:00;384;241;143
pondelok;18.5.2020;19:00;293;173;120
pondelok;18.5.2020;20:00;120;78;42
pondelok;18.5.2020;21:00;27;15;12
pondelok;18.5.2020;22:00;10;5;5
pondelok;18.5.2020;23:00;7;5;2
utorok;19.5.2020;0:00;2;2;0
utorok;19.5.2020;1:00;1;0;1
utorok;19.5.2020;2:00;1;1;0
utorok;19.5.2020;3:00;0;0;0
utorok;19.5.2020;4:00;0;0;0
utorok;19.5.2020;5:00;14;6;8
utorok;19.5.2020;6:00;48;28;20
utorok;19.5.2020;7:00;59;41;18
utorok;19.5.2020;8:00;84;46;38
utorok;19.5.2020;9:00;67;40;27
utorok;19.5.2020;10:00;93;55;38
utorok;19.5.2020;11:00;103;56;47
utorok;19.5.2020;12:00;94;48;46
utorok;19.5.2020;13:00;115;63;52
utorok;19.5.2020;14:00;155;77;78
utorok;19.5.2020;15:00;212;111;101
utorok;19.5.2020;16:00;306;183;123
utorok;19.5.2020;17:00;350;209;141
utorok;19.5.2020;18:00;307;179;128
utorok;19.5.2020;19:00;197;109;88
utorok;19.5.2020;20:00;63;42;21
utorok;19.5.2020;21:00;24;14;10
utorok;19.5.2020;22:00;13;6;7
utorok;19.5.2020;23:00;2;2;0
streda;20.5.2020;0:00;4;2;2
streda;20.5.2020;1:00;0;0;0
streda;20.5.2020;2:00;1;1;0
streda;20.5.2020;3:00;0;0;0
streda;20.5.2020;4:00;0;0;0
streda;20.5.2020;5:00;10;5;5
streda;20.5.2020;6:00;42;21;21
streda;20.5.2020;7:00;49;33;16
streda;20.5.2020;8:00;65;37;28
streda;20.5.2020;9:00;42;27;15
streda;20.5.2020;10:00;55;30;25
streda;20.5.2020;11:00;73;41;32
streda;20.5.2020;12:00;61;37;24
streda;20.5.2020;13:00;64;36;28
streda;20.5.2020;14:00;93;53;40
streda;20.5.2020;15:00;124;54;70
streda;20.5.2020;16:00;193;112;81
streda;20.5.2020;17:00;240;131;109
streda;20.5.2020;18:00;272;148;124
streda;20.5.2020;19:00;178;111;67
streda;20.5.2020;20:00;85;51;34
streda;20.5.2020;21:00;45;32;13
streda;20.5.2020;22:00;14;9;5
streda;20.5.2020;23:00;2;2;0
štvrtok;21.5.2020;0:00;4;2;2
štvrtok;21.5.2020;1:00;2;1;1
štvrtok;21.5.2020;2:00;0;0;0
štvrtok;21.5.2020;3:00;0;0;0
štvrtok;21.5.2020;4:00;0;0;0
štvrtok;21.5.2020;5:00;8;5;3
štvrtok;21.5.2020;6:00;43;27;16
štvrtok;21.5.2020;7:00;56;32;24
štvrtok;21.5.2020;8:00;69;37;32
štvrtok;21.5.2020;9:00;62;30;32
štvrtok;21.5.2020;10:00;61;34;27
štvrtok;21.5.2020;11:00;77;43;34
štvrtok;21.5.2020;12:00;62;36;26
štvrtok;21.5.2020;13:00;93;53;40
štvrtok;21.5.2020;14:00;128;52;76
štvrtok;21.5.2020;15:00;173;87;86
štvrtok;21.5.2020;16:00;218;115;103
štvrtok;21.5.2020;17:00;323;185;138
štvrtok;21.5.2020;18:00;298;163;135
štvrtok;21.5.2020;19:00;206;106;100
štvrtok;21.5.2020;20:00;96;58;38
štvrtok;21.5.2020;21:00;29;17;12
štvrtok;21.5.2020;22:00;15;7;8
štvrtok;21.5.2020;23:00;4;4;0
piatok;22.5.2020;0:00;3;1;2
piatok;22.5.2020;1:00;0;0;0
piatok;22.5.2020;2:00;0;0;0
piatok;22.5.2020;3:00;0;0;0
piatok;22.5.2020;4:00;1;0;1
piatok;22.5.2020;5:00;7;2;5
piatok;22.5.2020;6:00;33;21;12
piatok;22.5.2020;7:00;45;19;26
piatok;22.5.2020;8:00;59;29;30
piatok;22.5.2020;9:00;65;36;29
piatok;22.5.2020;10:00;85;40;45
piatok;22.5.2020;11:00;103;58;45
piatok;22.5.2020;12:00;90;53;37
piatok;22.5.2020;13:00;146;81;65
piatok;22.5.2020;14:00;141;68;73
piatok;22.5.2020;15:00;255;161;94
piatok;22.5.2020;16:00;299;170;129
piatok;22.5.2020;17:00;316;157;159
piatok;22.5.2020;18:00;245;165;80
piatok;22.5.2020;19:00;196;113;83
piatok;22.5.2020;20:00;59;41;18
piatok;22.5.2020;21:00;25;21;4
piatok;22.5.2020;22:00;18;11;7
piatok;22.5.2020;23:00;9;3;6
sobota;23.5.2020;0:00;4;1;3
sobota;23.5.2020;1:00;1;0;1
sobota;23.5.2020;2:00;9;0;9
sobota;23.5.2020;3:00;1;1;0
sobota;23.5.2020;4:00;3;3;0
sobota;23.5.2020;5:00;1;1;0
sobota;23.5.2020;6:00;5;5;0
sobota;23.5.2020;7:00;11;3;8
sobota;23.5.2020;8:00;6;3;3
sobota;23.5.2020;9:00;7;6;1
sobota;23.5.2020;10:00;4;3;1
sobota;23.5.2020;11:00;7;0;7
sobota;23.5.2020;12:00;8;2;6
sobota;23.5.2020;13:00;9;7;2
sobota;23.5.2020;14:00;29;16;13
sobota;23.5.2020;15:00;60;29;31
sobota;23.5.2020;16:00;92;47;45
sobota;23.5.2020;17:00;97;63;34
sobota;23.5.2020;18:00;57;37;20
sobota;23.5.2020;19:00;59;26;33
sobota;23.5.2020;20:00;19;15;4
sobota;23.5.2020;21:00;0;0;0
sobota;23.5.2020;22:00;1;1;0
sobota;23.5.2020;23:00;0;0;0
nede?a;24.5.2020;0:00;0;0;0
nede?a;24.5.2020;1:00;0;0;0
nede?a;24.5.2020;2:00;0;0;0
nede?a;24.5.2020;3:00;0;0;0
nede?a;24.5.2020;4:00;0;0;0
nede?a;24.5.2020;5:00;0;0;0
nede?a;24.5.2020;6:00;1;1;0
nede?a;24.5.2020;7:00;4;2;2
nede?a;24.5.2020;8:00;25;11;14
nede?a;24.5.2020;9:00;54;32;22
nede?a;24.5.2020;10:00;88;42;46
nede?a;24.5.2020;11:00;104;65;39
nede?a;24.5.2020;12:00;99;66;33
nede?a;24.5.2020;13:00;101;67;34
nede?a;24.5.2020;14:00;165;92;73
nede?a;24.5.2020;15:00;178;86;92
nede?a;24.5.2020;16:00;207;107;100
nede?a;24.5.2020;17:00;165;88;77
nede?a;24.5.2020;18:00;136;67;69
nede?a;24.5.2020;19:00;91;57;34
nede?a;24.5.2020;20:00;37;20;17
nede?a;24.5.2020;21:00;12;8;4
nede?a;24.5.2020;22:00;7;2;5
nede?a;24.5.2020;23:00;3;3;0
pondelok;25.5.2020;0:00;2;0;2
pondelok;25.5.2020;1:00;0;0;0
pondelok;25.5.2020;2:00;0;0;0
pondelok;25.5.2020;3:00;0;0;0
pondelok;25.5.2020;4:00;0;0;0
pondelok;25.5.2020;5:00;6;4;2
pondelok;25.5.2020;6:00;2;1;1
pondelok;25.5.2020;7:00;8;3;5
pondelok;25.5.2020;8:00;15;6;9
pondelok;25.5.2020;9:00;12;7;5
pondelok;25.5.2020;10:00;13;6;7
pondelok;25.5.2020;11:00;9;4;5
pondelok;25.5.2020;12:00;6;4;2
pondelok;25.5.2020;13:00;12;6;6
pondelok;25.5.2020;14:00;13;8;5
pondelok;25.5.2020;15:00;22;11;11
pondelok;25.5.2020;16:00;31;17;14
pondelok;25.5.2020;17:00;74;42;32
pondelok;25.5.2020;18:00;80;42;38
pondelok;25.5.2020;19:00;68;37;31
pondelok;25.5.2020;20:00;36;23;13
pondelok;25.5.2020;21:00;7;5;2
pondelok;25.5.2020;22:00;4;1;3
pondelok;25.5.2020;23:00;0;0;0
utorok;26.5.2020;0:00;2;1;1
utorok;26.5.2020;1:00;0;0;0
utorok;26.5.2020;2:00;1;1;0
utorok;26.5.2020;3:00;0;0;0
utorok;26.5.2020;4:00;0;0;0
utorok;26.5.2020;5:00;5;3;2
utorok;26.5.2020;6:00;18;13;5
utorok;26.5.2020;7:00;25;13;12
utorok;26.5.2020;8:00;33;18;15
utorok;26.5.2020;9:00;26;16;10
utorok;26.5.2020;10:00;22;13;9
utorok;26.5.2020;11:00;20;8;12
utorok;26.5.2020;12:00;4;1;3
utorok;26.5.2020;13:00;9;4;5
utorok;26.5.2020;14:00;23;10;13
utorok;26.5.2020;15:00;40;20;20
utorok;26.5.2020;16:00;92;52;40
utorok;26.5.2020;17:00;126;76;50
utorok;26.5.2020;18:00;168;93;75
utorok;26.5.2020;19:00;109;59;50
utorok;26.5.2020;20:00;61;44;17
utorok;26.5.2020;21:00;17;10;7
utorok;26.5.2020;22:00;6;5;1
utorok;26.5.2020;23:00;3;0;3
streda;27.5.2020;0:00;0;0;0
streda;27.5.2020;1:00;0;0;0
streda;27.5.2020;2:00;0;0;0
streda;27.5.2020;3:00;0;0;0
streda;27.5.2020;4:00;1;0;1
streda;27.5.2020;5:00;7;2;5
streda;27.5.2020;6:00;25;20;5
streda;27.5.2020;7:00;49;32;17
streda;27.5.2020;8:00;50;24;26
streda;27.5.2020;9:00;32;21;11
streda;27.5.2020;10:00;35;16;19
streda;27.5.2020;11:00;46;19;27
streda;27.5.2020;12:00;69;34;35
streda;27.5.2020;13:00;85;45;40
streda;27.5.2020;14:00;83;44;39
streda;27.5.2020;15:00;166;81;85
streda;27.5.2020;16:00;221;113;108
streda;27.5.2020;17:00;288;160;128
streda;27.5.2020;18:00;281;166;115
streda;27.5.2020;19:00;207;126;81
streda;27.5.2020;20:00;111;63;48
streda;27.5.2020;21:00;34;14;20
streda;27.5.2020;22:00;17;10;7
streda;27.5.2020;23:00;6;4;2
štvrtok;28.5.2020;0:00;1;1;0
štvrtok;28.5.2020;1:00;1;1;0
štvrtok;28.5.2020;2:00;0;0;0
štvrtok;28.5.2020;3:00;0;0;0
štvrtok;28.5.2020;4:00;0;0;0
štvrtok;28.5.2020;5:00;4;1;3
štvrtok;28.5.2020;6:00;27;21;6
štvrtok;28.5.2020;7:00;48;23;25
štvrtok;28.5.2020;8:00;55;24;31
štvrtok;28.5.2020;9:00;39;21;18
štvrtok;28.5.2020;10:00;50;29;21
štvrtok;28.5.2020;11:00;50;22;28
štvrtok;28.5.2020;12:00;60;35;25
štvrtok;28.5.2020;13:00;53;31;22
štvrtok;28.5.2020;14:00;53;29;24
štvrtok;28.5.2020;15:00;47;22;25
štvrtok;28.5.2020;16:00;24;13;11
štvrtok;28.5.2020;17:00;30;15;15
štvrtok;28.5.2020;18:00;43;22;21
štvrtok;28.5.2020;19:00;28;14;14
štvrtok;28.5.2020;20:00;22;12;10
štvrtok;28.5.2020;21:00;11;4;7
štvrtok;28.5.2020;22:00;2;1;1
štvrtok;28.5.2020;23:00;6;3;3
piatok;29.5.2020;0:00;1;0;1
piatok;29.5.2020;1:00;0;0;0
piatok;29.5.2020;2:00;0;0;0
piatok;29.5.2020;3:00;0;0;0
piatok;29.5.2020;4:00;0;0;0
piatok;29.5.2020;5:00;8;3;5
piatok;29.5.2020;6:00;14;5;9
piatok;29.5.2020;7:00;30;16;14
piatok;29.5.2020;8:00;29;16;13
piatok;29.5.2020;9:00;31;17;14
piatok;29.5.2020;10:00;27;16;11
piatok;29.5.2020;11:00;36;17;19
piatok;29.5.2020;12:00;39;22;17
piatok;29.5.2020;13:00;43;29;14
piatok;29.5.2020;14:00;68;25;43
piatok;29.5.2020;15:00;106;61;45
piatok;29.5.2020;16:00;170;88;82
piatok;29.5.2020;17:00;133;75;58
piatok;29.5.2020;18:00;130;80;50
piatok;29.5.2020;19:00;87;51;36
piatok;29.5.2020;20:00;52;31;21
piatok;29.5.2020;21:00;22;17;5
piatok;29.5.2020;22:00;1;0;1
piatok;29.5.2020;23:00;4;1;3
sobota;30.5.2020;0:00;13;10;3
sobota;30.5.2020;1:00;3;2;1
sobota;30.5.2020;2:00;2;2;0
sobota;30.5.2020;3:00;0;0;0
sobota;30.5.2020;4:00;1;0;1
sobota;30.5.2020;5:00;1;0;1
sobota;30.5.2020;6:00;9;7;2
sobota;30.5.2020;7:00;22;14;8
sobota;30.5.2020;8:00;29;16;13
sobota;30.5.2020;9:00;64;38;26
sobota;30.5.2020;10:00;114;61;53
sobota;30.5.2020;11:00;149;77;72
sobota;30.5.2020;12:00;141;76;65
sobota;30.5.2020;13:00;210;132;78
sobota;30.5.2020;14:00;242;153;89
sobota;30.5.2020;15:00;233;124;109
sobota;30.5.2020;16:00;234;118;116
sobota;30.5.2020;17:00;194;113;81
sobota;30.5.2020;18:00;165;92;73
sobota;30.5.2020;19:00;57;29;28
sobota;30.5.2020;20:00;46;22;24
sobota;30.5.2020;21:00;12;8;4
sobota;30.5.2020;22:00;5;0;5
sobota;30.5.2020;23:00;3;1;2
nede?a;31.5.2020;0:00;5;4;1
nede?a;31.5.2020;1:00;2;0;2
nede?a;31.5.2020;2:00;0;0;0
nede?a;31.5.2020;3:00;0;0;0
nede?a;31.5.2020;4:00;0;0;0
nede?a;31.5.2020;5:00;1;1;0
nede?a;31.5.2020;6:00;5;2;3
nede?a;31.5.2020;7:00;9;4;5
nede?a;31.5.2020;8:00;18;10;8
nede?a;31.5.2020;9:00;2;0;2
nede?a;31.5.2020;10:00;5;4;1
nede?a;31.5.2020;11:00;4;1;3
nede?a;31.5.2020;12:00;1;0;1
nede?a;31.5.2020;13:00;1;1;0
nede?a;31.5.2020;14:00;1;1;0
nede?a;31.5.2020;15:00;9;4;5
nede?a;31.5.2020;16:00;8;5;3
nede?a;31.5.2020;17:00;7;1;6
nede?a;31.5.2020;18:00;8;5;3
nede?a;31.5.2020;19:00;7;4;3
nede?a;31.5.2020;20:00;4;0;4
nede?a;31.5.2020;21:00;2;2;0
nede?a;31.5.2020;22:00;5;3;2
nede?a;31.5.2020;23:00;1;0;1
pondelok;1.6.2020;0:00;0;0;0
pondelok;1.6.2020;1:00;0;0;0
pondelok;1.6.2020;2:00;0;0;0
pondelok;1.6.2020;3:00;1;1;0
pondelok;1.6.2020;4:00;0;0;0
pondelok;1.6.2020;5:00;11;5;6
pondelok;1.6.2020;6:00;26;14;12
pondelok;1.6.2020;7:00;47;27;20
pondelok;1.6.2020;8:00;58;30;28
pondelok;1.6.2020;9:00;32;21;11
pondelok;1.6.2020;10:00;49;23;26
pondelok;1.6.2020;11:00;69;38;31
pondelok;1.6.2020;12:00;64;37;27
pondelok;1.6.2020;13:00;65;33;32
pondelok;1.6.2020;14:00;85;47;38
pondelok;1.6.2020;15:00;146;80;66
pondelok;1.6.2020;16:00;248;112;136
pondelok;1.6.2020;17:00;315;149;166
pondelok;1.6.2020;18:00;306;184;122
pondelok;1.6.2020;19:00;245;166;79
pondelok;1.6.2020;20:00;146;96;50
pondelok;1.6.2020;21:00;33;19;14
pondelok;1.6.2020;22:00;14;5;9
pondelok;1.6.2020;23:00;2;2;0
utorok;2.6.2020;0:00;3;2;1
utorok;2.6.2020;1:00;0;0;0
utorok;2.6.2020;2:00;1;1;0
utorok;2.6.2020;3:00;0;0;0
utorok;2.6.2020;4:00;1;0;1
utorok;2.6.2020;5:00;11;6;5
utorok;2.6.2020;6:00;40;21;19
utorok;2.6.2020;7:00;66;43;23
utorok;2.6.2020;8:00;55;30;25
utorok;2.6.2020;9:00;43;24;19
utorok;2.6.2020;10:00;50;24;26
utorok;2.6.2020;11:00;72;30;42
utorok;2.6.2020;12:00;55;24;31
utorok;2.6.2020;13:00;72;39;33
utorok;2.6.2020;14:00;91;55;36
utorok;2.6.2020;15:00;145;71;74
utorok;2.6.2020;16:00;236;131;105
utorok;2.6.2020;17:00;307;177;130
utorok;2.6.2020;18:00;278;161;117
utorok;2.6.2020;19:00;217;127;90
utorok;2.6.2020;20:00;105;52;53
utorok;2.6.2020;21:00;29;18;11
utorok;2.6.2020;22:00;17;10;7
utorok;2.6.2020;23:00;5;3;2
streda;3.6.2020;0:00;1;0;1
streda;3.6.2020;1:00;2;2;0
streda;3.6.2020;2:00;0;0;0
streda;3.6.2020;3:00;0;0;0
streda;3.6.2020;4:00;1;0;1
streda;3.6.2020;5:00;7;3;4
streda;3.6.2020;6:00;28;17;11
streda;3.6.2020;7:00;54;29;25
streda;3.6.2020;8:00;66;38;28
streda;3.6.2020;9:00;50;31;19
streda;3.6.2020;10:00;55;24;31
streda;3.6.2020;11:00;69;36;33
streda;3.6.2020;12:00;60;34;26
streda;3.6.2020;13:00;68;32;36
streda;3.6.2020;14:00;64;36;28
streda;3.6.2020;15:00;132;68;64
streda;3.6.2020;16:00;228;106;122
streda;3.6.2020;17:00;329;181;148
streda;3.6.2020;18:00;238;146;92
streda;3.6.2020;19:00;249;146;103
streda;3.6.2020;20:00;99;57;42
streda;3.6.2020;21:00;38;25;13
streda;3.6.2020;22:00;14;7;7
streda;3.6.2020;23:00;7;4;3
štvrtok;4.6.2020;0:00;4;2;2
štvrtok;4.6.2020;1:00;4;4;0
štvrtok;4.6.2020;2:00;2;2;0
štvrtok;4.6.2020;3:00;0;0;0
štvrtok;4.6.2020;4:00;0;0;0
štvrtok;4.6.2020;5:00;12;6;6
štvrtok;4.6.2020;6:00;46;24;22
štvrtok;4.6.2020;7:00;59;39;20
štvrtok;4.6.2020;8:00;93;46;47
štvrtok;4.6.2020;9:00;64;34;30
štvrtok;4.6.2020;10:00;64;29;35
štvrtok;4.6.2020;11:00;67;41;26
štvrtok;4.6.2020;12:00;79;50;29
štvrtok;4.6.2020;13:00;80;44;36
štvrtok;4.6.2020;14:00;135;66;69
štvrtok;4.6.2020;15:00;218;117;101
štvrtok;4.6.2020;16:00;265;155;110
štvrtok;4.6.2020;17:00;317;170;147
štvrtok;4.6.2020;18:00;213;138;75
štvrtok;4.6.2020;19:00;143;86;57
štvrtok;4.6.2020;20:00;74;47;27
štvrtok;4.6.2020;21:00;30;14;16
štvrtok;4.6.2020;22:00;11;9;2
štvrtok;4.6.2020;23:00;3;2;1
piatok;5.6.2020;0:00;3;0;3
piatok;5.6.2020;1:00;0;0;0
piatok;5.6.2020;2:00;1;1;0
piatok;5.6.2020;3:00;0;0;0
piatok;5.6.2020;4:00;2;2;0
piatok;5.6.2020;5:00;1;1;0
piatok;5.6.2020;6:00;4;2;2
piatok;5.6.2020;7:00;10;5;5
piatok;5.6.2020;8:00;12;7;5
piatok;5.6.2020;9:00;1;0;1
piatok;5.6.2020;10:00;6;3;3
piatok;5.6.2020;11:00;3;2;1
piatok;5.6.2020;12:00;7;4;3
piatok;5.6.2020;13:00;14;7;7
piatok;5.6.2020;14:00;18;11;7
piatok;5.6.2020;15:00;42;21;21
piatok;5.6.2020;16:00;67;34;33
piatok;5.6.2020;17:00;125;92;33
piatok;5.6.2020;18:00;94;52;42
piatok;5.6.2020;19:00;86;45;41
piatok;5.6.2020;20:00;41;23;18
piatok;5.6.2020;21:00;14;6;8
piatok;5.6.2020;22:00;11;8;3
piatok;5.6.2020;23:00;7;5;2
sobota;6.6.2020;0:00;12;7;5
sobota;6.6.2020;1:00;6;4;2
sobota;6.6.2020;2:00;0;0;0
sobota;6.6.2020;3:00;0;0;0
sobota;6.6.2020;4:00;1;0;1
sobota;6.6.2020;5:00;6;4;2
sobota;6.6.2020;6:00;13;9;4
sobota;6.6.2020;7:00;21;11;10
sobota;6.6.2020;8:00;88;57;31
sobota;6.6.2020;9:00;139;90;49
sobota;6.6.2020;10:00;242;170;72
sobota;6.6.2020;11:00;353;230;123
sobota;6.6.2020;12:00;308;173;135
sobota;6.6.2020;13:00;376;222;154
sobota;6.6.2020;14:00;431;261;170
sobota;6.6.2020;15:00;507;273;234
sobota;6.6.2020;16:00;502;251;251
sobota;6.6.2020;17:00;431;206;225
sobota;6.6.2020;18:00;295;144;151
sobota;6.6.2020;19:00;226;128;98
sobota;6.6.2020;20:00;127;62;65
sobota;6.6.2020;21:00;40;16;24
sobota;6.6.2020;22:00;21;12;9
sobota;6.6.2020;23:00;5;3;2
nede?a;7.6.2020;0:00;4;1;3
nede?a;7.6.2020;1:00;5;1;4
nede?a;7.6.2020;2:00;0;0;0
nede?a;7.6.2020;3:00;0;0;0
nede?a;7.6.2020;4:00;0;0;0
nede?a;7.6.2020;5:00;2;1;1
nede?a;7.6.2020;6:00;12;8;4
nede?a;7.6.2020;7:00;24;14;10
nede?a;7.6.2020;8:00;73;54;19
nede?a;7.6.2020;9:00;200;142;58
nede?a;7.6.2020;10:00;246;151;95
nede?a;7.6.2020;11:00;291;152;139
nede?a;7.6.2020;12:00;302;165;137
nede?a;7.6.2020;13:00;265;147;118
nede?a;7.6.2020;14:00;300;174;126
nede?a;7.6.2020;15:00;341;195;146
nede?a;7.6.2020;16:00;354;186;168
nede?a;7.6.2020;17:00;308;131;177
nede?a;7.6.2020;18:00;213;114;99
nede?a;7.6.2020;19:00;113;68;45
nede?a;7.6.2020;20:00;41;24;17
nede?a;7.6.2020;21:00;9;6;3
nede?a;7.6.2020;22:00;2;1;1
nede?a;7.6.2020;23:00;2;1;1
pondelok;8.6.2020;0:00;0;0;0
pondelok;8.6.2020;1:00;0;0;0
pondelok;8.6.2020;2:00;0;0;0
pondelok;8.6.2020;3:00;0;0;0
pondelok;8.6.2020;4:00;0;0;0
pondelok;8.6.2020;5:00;13;7;6
pondelok;8.6.2020;6:00;24;16;8
pondelok;8.6.2020;7:00;39;26;13
pondelok;8.6.2020;8:00;42;22;20
pondelok;8.6.2020;9:00;20;8;12
pondelok;8.6.2020;10:00;11;5;6
pondelok;8.6.2020;11:00;16;11;5
pondelok;8.6.2020;12:00;21;9;12
pondelok;8.6.2020;13:00;16;5;11
pondelok;8.6.2020;14:00;43;28;15
pondelok;8.6.2020;15:00;73;36;37
pondelok;8.6.2020;16:00;144;89;55
pondelok;8.6.2020;17:00;172;99;73
pondelok;8.6.2020;18:00;165;102;63
pondelok;8.6.2020;19:00;114;48;66
pondelok;8.6.2020;20:00;47;16;31
pondelok;8.6.2020;21:00;25;14;11
pondelok;8.6.2020;22:00;5;2;3
pondelok;8.6.2020;23:00;2;2;0
utorok;9.6.2020;0:00;3;1;2
utorok;9.6.2020;1:00;2;1;1
utorok;9.6.2020;2:00;1;0;1
utorok;9.6.2020;3:00;0;0;0
utorok;9.6.2020;4:00;0;0;0
utorok;9.6.2020;5:00;15;9;6
utorok;9.6.2020;6:00;48;35;13
utorok;9.6.2020;7:00;59;29;30
utorok;9.6.2020;8:00;87;48;39
utorok;9.6.2020;9:00;52;29;23
utorok;9.6.2020;10:00;48;27;21
utorok;9.6.2020;11:00;65;33;32
utorok;9.6.2020;12:00;55;32;23
utorok;9.6.2020;13:00;83;50;33
utorok;9.6.2020;14:00;99;57;42
utorok;9.6.2020;15:00;138;77;61
utorok;9.6.2020;16:00;153;87;66
utorok;9.6.2020;17:00;211;141;70
utorok;9.6.2020;18:00;159;87;72
utorok;9.6.2020;19:00;111;45;66
utorok;9.6.2020;20:00;34;23;11
utorok;9.6.2020;21:00;28;15;13
utorok;9.6.2020;22:00;10;7;3
utorok;9.6.2020;23:00;5;0;5
streda;10.6.2020;0:00;1;0;1
streda;10.6.2020;1:00;0;0;0
streda;10.6.2020;2:00;0;0;0
streda;10.6.2020;3:00;0;0;0
streda;10.6.2020;4:00;0;0;0
streda;10.6.2020;5:00;5;2;3
streda;10.6.2020;6:00;13;9;4
streda;10.6.2020;7:00;18;9;9
streda;10.6.2020;8:00;15;8;7
streda;10.6.2020;9:00;8;4;4
streda;10.6.2020;10:00;0;0;0
streda;10.6.2020;11:00;8;1;7
streda;10.6.2020;12:00;5;1;4
streda;10.6.2020;13:00;15;7;8
streda;10.6.2020;14:00;16;7;9
streda;10.6.2020;15:00;42;25;17
streda;10.6.2020;16:00;88;42;46
streda;10.6.2020;17:00;164;109;55
streda;10.6.2020;18:00;178;101;77
streda;10.6.2020;19:00;198;104;94
streda;10.6.2020;20:00;84;45;39
streda;10.6.2020;21:00;38;19;19
streda;10.6.2020;22:00;12;5;7
streda;10.6.2020;23:00;3;0;3
štvrtok;11.6.2020;0:00;3;1;2
štvrtok;11.6.2020;1:00;2;1;1
štvrtok;11.6.2020;2:00;0;0;0
štvrtok;11.6.2020;3:00;0;0;0
štvrtok;11.6.2020;4:00;2;1;1
štvrtok;11.6.2020;5:00;13;6;7
štvrtok;11.6.2020;6:00;58;26;32
štvrtok;11.6.2020;7:00;81;41;40
štvrtok;11.6.2020;8:00;86;40;46
štvrtok;11.6.2020;9:00;48;23;25
štvrtok;11.6.2020;10:00;58;36;22
štvrtok;11.6.2020;11:00;62;39;23
štvrtok;11.6.2020;12:00;67;30;37
štvrtok;11.6.2020;13:00;87;43;44
štvrtok;11.6.2020;14:00;119;79;40
štvrtok;11.6.2020;15:00;172;91;81
štvrtok;11.6.2020;16:00;274;159;115
štvrtok;11.6.2020;17:00;434;279;155
štvrtok;11.6.2020;18:00;334;187;147
štvrtok;11.6.2020;19:00;283;134;149
štvrtok;11.6.2020;20:00;159;80;79
štvrtok;11.6.2020;21:00;56;35;21
štvrtok;11.6.2020;22:00;16;12;4
štvrtok;11.6.2020;23:00;9;4;5
piatok;12.6.2020;0:00;4;3;1
piatok;12.6.2020;1:00;2;0;2
piatok;12.6.2020;2:00;3;3;0
piatok;12.6.2020;3:00;0;0;0
piatok;12.6.2020;4:00;0;0;0
piatok;12.6.2020;5:00;6;3;3
piatok;12.6.2020;6:00;50;34;16
piatok;12.6.2020;7:00;48;26;22
piatok;12.6.2020;8:00;86;44;42
piatok;12.6.2020;9:00;71;37;34
piatok;12.6.2020;10:00;84;51;33
piatok;12.6.2020;11:00;77;54;23
piatok;12.6.2020;12:00;94;39;55
piatok;12.6.2020;13:00;104;59;45
piatok;12.6.2020;14:00;159;74;85
piatok;12.6.2020;15:00;184;104;80
piatok;12.6.2020;16:00;269;132;137
piatok;12.6.2020;17:00;273;160;113
piatok;12.6.2020;18:00;267;144;123
piatok;12.6.2020;19:00;206;99;107
piatok;12.6.2020;20:00;86;39;47
piatok;12.6.2020;21:00;53;31;22
piatok;12.6.2020;22:00;22;14;8
piatok;12.6.2020;23:00;17;9;8
sobota;13.6.2020;0:00;12;5;7
sobota;13.6.2020;1:00;8;4;4
sobota;13.6.2020;2:00;10;3;7
sobota;13.6.2020;3:00;2;1;1
sobota;13.6.2020;4:00;0;0;0
sobota;13.6.2020;5:00;6;4;2
sobota;13.6.2020;6:00;21;16;5
sobota;13.6.2020;7:00;46;33;13
sobota;13.6.2020;8:00;149;120;29
sobota;13.6.2020;9:00;294;211;83
sobota;13.6.2020;10:00;360;258;102
sobota;13.6.2020;11:00;361;205;156
sobota;13.6.2020;12:00;306;161;145
sobota;13.6.2020;13:00;277;141;136
sobota;13.6.2020;14:00;308;148;160
sobota;13.6.2020;15:00;363;190;173
sobota;13.6.2020;16:00;323;193;130
sobota;13.6.2020;17:00;244;130;114
sobota;13.6.2020;18:00;248;119;129
sobota;13.6.2020;19:00;178;101;77
sobota;13.6.2020;20:00;128;63;65
sobota;13.6.2020;21:00;58;32;26
sobota;13.6.2020;22:00;13;7;6
sobota;13.6.2020;23:00;9;7;2
nede?a;14.6.2020;0:00;5;2;3
nede?a;14.6.2020;1:00;3;3;0
nede?a;14.6.2020;2:00;1;0;1
nede?a;14.6.2020;3:00;1;0;1
nede?a;14.6.2020;4:00;0;0;0
nede?a;14.6.2020;5:00;6;4;2
nede?a;14.6.2020;6:00;18;10;8
nede?a;14.6.2020;7:00;32;19;13
nede?a;14.6.2020;8:00;93;64;29
nede?a;14.6.2020;9:00;195;134;61
nede?a;14.6.2020;10:00;228;150;78
nede?a;14.6.2020;11:00;193;89;104
nede?a;14.6.2020;12:00;147;74;73
nede?a;14.6.2020;13:00;191;114;77
nede?a;14.6.2020;14:00;192;85;107
nede?a;14.6.2020;15:00;219;95;124
nede?a;14.6.2020;16:00;95;52;43
nede?a;14.6.2020;17:00;60;27;33
nede?a;14.6.2020;18:00;9;2;7
nede?a;14.6.2020;19:00;9;7;2
nede?a;14.6.2020;20:00;12;6;6
nede?a;14.6.2020;21:00;6;4;2
nede?a;14.6.2020;22:00;3;3;0
nede?a;14.6.2020;23:00;2;1;1
pondelok;15.6.2020;0:00;0;0;0
pondelok;15.6.2020;1:00;0;0;0
pondelok;15.6.2020;2:00;0;0;0
pondelok;15.6.2020;3:00;0;0;0
pondelok;15.6.2020;4:00;2;2;0
pondelok;15.6.2020;5:00;8;1;7
pondelok;15.6.2020;6:00;25;14;11
pondelok;15.6.2020;7:00;35;18;17
pondelok;15.6.2020;8:00;47;25;22
pondelok;15.6.2020;9:00;23;11;12
pondelok;15.6.2020;10:00;24;9;15
pondelok;15.6.2020;11:00;20;9;11
pondelok;15.6.2020;12:00;42;23;19
pondelok;15.6.2020;13:00;36;19;17
pondelok;15.6.2020;14:00;64;26;38
pondelok;15.6.2020;15:00;117;68;49
pondelok;15.6.2020;16:00;177;95;82
pondelok;15.6.2020;17:00;258;154;104
pondelok;15.6.2020;18:00;183;114;69
pondelok;15.6.2020;19:00;183;93;90
pondelok;15.6.2020;20:00;125;65;60
pondelok;15.6.2020;21:00;26;14;12
pondelok;15.6.2020;22:00;18;7;11
pondelok;15.6.2020;23:00;6;3;3
utorok;16.6.2020;0:00;2;2;0
utorok;16.6.2020;1:00;1;1;0
utorok;16.6.2020;2:00;0;0;0
utorok;16.6.2020;3:00;0;0;0
utorok;16.6.2020;4:00;2;1;1
utorok;16.6.2020;5:00;14;10;4
utorok;16.6.2020;6:00;61;30;31
utorok;16.6.2020;7:00;72;34;38
utorok;16.6.2020;8:00;80;35;45
utorok;16.6.2020;9:00;61;40;21
utorok;16.6.2020;10:00;81;55;26
utorok;16.6.2020;11:00;44;26;18
utorok;16.6.2020;12:00;37;19;18
utorok;16.6.2020;13:00;41;18;23
utorok;16.6.2020;14:00;49;30;19
utorok;16.6.2020;15:00;123;61;62
utorok;16.6.2020;16:00;156;96;60
utorok;16.6.2020;17:00;210;131;79
utorok;16.6.2020;18:00;162;88;74
utorok;16.6.2020;19:00;157;86;71
utorok;16.6.2020;20:00;68;31;37
utorok;16.6.2020;21:00;25;8;17
utorok;16.6.2020;22:00;14;10;4
utorok;16.6.2020;23:00;8;6;2
streda;17.6.2020;0:00;0;0;0
streda;17.6.2020;1:00;0;0;0
streda;17.6.2020;2:00;0;0;0
streda;17.6.2020;3:00;0;0;0
streda;17.6.2020;4:00;2;2;0
streda;17.6.2020;5:00;10;5;5
streda;17.6.2020;6:00;35;20;15
streda;17.6.2020;7:00;63;31;32
streda;17.6.2020;8:00;79;37;42
streda;17.6.2020;9:00;43;22;21
streda;17.6.2020;10:00;51;29;22
streda;17.6.2020;11:00;68;27;41
streda;17.6.2020;12:00;48;23;25
streda;17.6.2020;13:00;60;34;26
streda;17.6.2020;14:00;94;56;38
streda;17.6.2020;15:00;64;32;32
streda;17.6.2020;16:00;116;52;64
streda;17.6.2020;17:00;209;148;61
streda;17.6.2020;18:00;203;127;76
streda;17.6.2020;19:00;178;87;91
streda;17.6.2020;20:00;119;61;58
streda;17.6.2020;21:00;36;18;18
streda;17.6.2020;22:00;12;7;5
streda;17.6.2020;23:00;5;4;1
štvrtok;18.6.2020;0:00;3;2;1
štvrtok;18.6.2020;1:00;1;0;1
štvrtok;18.6.2020;2:00;0;0;0
štvrtok;18.6.2020;3:00;0;0;0
štvrtok;18.6.2020;4:00;0;0;0
štvrtok;18.6.2020;5:00;10;6;4
štvrtok;18.6.2020;6:00;40;23;17
štvrtok;18.6.2020;7:00;39;15;24
štvrtok;18.6.2020;8:00;41;20;21
štvrtok;18.6.2020;9:00;13;6;7
štvrtok;18.6.2020;10:00;7;3;4
štvrtok;18.6.2020;11:00;6;4;2
štvrtok;18.6.2020;12:00;9;7;2
štvrtok;18.6.2020;13:00;10;4;6
štvrtok;18.6.2020;14:00;22;11;11
štvrtok;18.6.2020;15:00;64;29;35
štvrtok;18.6.2020;16:00;96;57;39
štvrtok;18.6.2020;17:00;191;133;58
štvrtok;18.6.2020;18:00;156;84;72
štvrtok;18.6.2020;19:00;126;61;65
štvrtok;18.6.2020;20:00;95;42;53
štvrtok;18.6.2020;21:00;21;16;5
štvrtok;18.6.2020;22:00;13;1;12
štvrtok;18.6.2020;23:00;6;5;1
piatok;19.6.2020;0:00;0;0;0
piatok;19.6.2020;1:00;3;1;2
piatok;19.6.2020;2:00;1;1;0
piatok;19.6.2020;3:00;0;0;0
piatok;19.6.2020;4:00;1;0;1
piatok;19.6.2020;5:00;5;2;3
piatok;19.6.2020;6:00;8;5;3
piatok;19.6.2020;7:00;34;21;13
piatok;19.6.2020;8:00;29;16;13
piatok;19.6.2020;9:00;8;4;4
piatok;19.6.2020;10:00;6;4;2
piatok;19.6.2020;11:00;3;2;1
piatok;19.6.2020;12:00;5;4;1
piatok;19.6.2020;13:00;17;12;5
piatok;19.6.2020;14:00;32;17;15
piatok;19.6.2020;15:00;52;32;20
piatok;19.6.2020;16:00;130;73;57
piatok;19.6.2020;17:00;146;88;58
piatok;19.6.2020;18:00;168;94;74
piatok;19.6.2020;19:00;151;83;68
piatok;19.6.2020;20:00;104;43;61
piatok;19.6.2020;21:00;36;22;14
piatok;19.6.2020;22:00;14;10;4
piatok;19.6.2020;23:00;6;3;3
sobota;20.6.2020;0:00;3;3;0
sobota;20.6.2020;1:00;3;3;0
sobota;20.6.2020;2:00;4;2;2
sobota;20.6.2020;3:00;0;0;0
sobota;20.6.2020;4:00;1;1;0
sobota;20.6.2020;5:00;1;1;0
sobota;20.6.2020;6:00;16;14;2
sobota;20.6.2020;7:00;15;8;7
sobota;20.6.2020;8:00;39;18;21
sobota;20.6.2020;9:00;30;15;15
sobota;20.6.2020;10:00;24;9;15
sobota;20.6.2020;11:00;15;9;6
sobota;20.6.2020;12:00;13;7;6
sobota;20.6.2020;13:00;7;3;4
sobota;20.6.2020;14:00;14;5;9
sobota;20.6.2020;15:00;5;2;3
sobota;20.6.2020;16:00;3;1;2
sobota;20.6.2020;17:00;3;1;2
sobota;20.6.2020;18:00;4;3;1
sobota;20.6.2020;19:00;1;1;0
sobota;20.6.2020;20:00;2;0;2
sobota;20.6.2020;21:00;1;0;1
sobota;20.6.2020;22:00;2;0;2
sobota;20.6.2020;23:00;1;1;0
nede?a;21.6.2020;0:00;1;0;1
nede?a;21.6.2020;1:00;0;0;0
nede?a;21.6.2020;2:00;1;1;0
nede?a;21.6.2020;3:00;0;0;0
nede?a;21.6.2020;4:00;0;0;0
nede?a;21.6.2020;5:00;0;0;0
nede?a;21.6.2020;6:00;1;1;0
nede?a;21.6.2020;7:00;0;0;0
nede?a;21.6.2020;8:00;1;1;0
nede?a;21.6.2020;9:00;5;0;5
nede?a;21.6.2020;10:00;0;0;0
nede?a;21.6.2020;11:00;4;1;3
nede?a;21.6.2020;12:00;6;1;5
nede?a;21.6.2020;13:00;4;3;1
nede?a;21.6.2020;14:00;7;4;3
nede?a;21.6.2020;15:00;13;8;5
nede?a;21.6.2020;16:00;24;10;14
nede?a;21.6.2020;17:00;31;18;13
nede?a;21.6.2020;18:00;44;26;18
nede?a;21.6.2020;19:00;36;23;13
nede?a;21.6.2020;20:00;27;13;14
nede?a;21.6.2020;21:00;7;1;6
nede?a;21.6.2020;22:00;3;1;2
nede?a;21.6.2020;23:00;0;0;0
pondelok;22.6.2020;0:00;0;0;0
pondelok;22.6.2020;1:00;1;0;1
pondelok;22.6.2020;2:00;0;0;0
pondelok;22.6.2020;3:00;1;1;0
pondelok;22.6.2020;4:00;0;0;0
pondelok;22.6.2020;5:00;9;4;5
pondelok;22.6.2020;6:00;30;20;10
pondelok;22.6.2020;7:00;50;27;23
pondelok;22.6.2020;8:00;65;36;29
pondelok;22.6.2020;9:00;36;19;17
pondelok;22.6.2020;10:00;46;26;20
pondelok;22.6.2020;11:00;32;19;13
pondelok;22.6.2020;12:00;36;21;15
pondelok;22.6.2020;13:00;33;14;19
pondelok;22.6.2020;14:00;52;26;26
pondelok;22.6.2020;15:00;68;35;33
pondelok;22.6.2020;16:00;132;66;66
pondelok;22.6.2020;17:00;180;94;86
pondelok;22.6.2020;18:00;220;125;95
pondelok;22.6.2020;19:00;135;62;73
pondelok;22.6.2020;20:00;106;50;56
pondelok;22.6.2020;21:00;38;22;16
pondelok;22.6.2020;22:00;19;12;7
pondelok;22.6.2020;23:00;10;5;5
utorok;23.6.2020;0:00;1;0;1
utorok;23.6.2020;1:00;1;0;1
utorok;23.6.2020;2:00;0;0;0
utorok;23.6.2020;3:00;0;0;0
utorok;23.6.2020;4:00;0;0;0
utorok;23.6.2020;5:00;17;11;6
utorok;23.6.2020;6:00;76;49;27
utorok;23.6.2020;7:00;96;45;51
utorok;23.6.2020;8:00;102;50;52
utorok;23.6.2020;9:00;58;37;21
utorok;23.6.2020;10:00;67;35;32
utorok;23.6.2020;11:00;65;37;28
utorok;23.6.2020;12:00;53;22;31
utorok;23.6.2020;13:00;84;51;33
utorok;23.6.2020;14:00;85;51;34
utorok;23.6.2020;15:00;169;103;66
utorok;23.6.2020;16:00;255;150;105
utorok;23.6.2020;17:00;403;248;155
utorok;23.6.2020;18:00;378;192;186
utorok;23.6.2020;19:00;322;173;149
utorok;23.6.2020;20:00;217;131;86
utorok;23.6.2020;21:00;64;32;32
utorok;23.6.2020;22:00;19;14;5
utorok;23.6.2020;23:00;6;4;2
streda;24.6.2020;0:00;5;5;0
streda;24.6.2020;1:00;0;0;0
streda;24.6.2020;2:00;1;0;1
streda;24.6.2020;3:00;0;0;0
streda;24.6.2020;4:00;0;0;0
streda;24.6.2020;5:00;11;7;4
streda;24.6.2020;6:00;42;18;24
streda;24.6.2020;7:00;89;47;42
streda;24.6.2020;8:00;97;48;49
streda;24.6.2020;9:00;71;42;29
streda;24.6.2020;10:00;64;35;29
streda;24.6.2020;11:00;57;29;28
streda;24.6.2020;12:00;65;26;39
streda;24.6.2020;13:00;70;38;32
streda;24.6.2020;14:00;98;55;43
streda;24.6.2020;15:00;162;90;72
streda;24.6.2020;16:00;215;124;91
streda;24.6.2020;17:00;375;225;150
streda;24.6.2020;18:00;324;191;133
streda;24.6.2020;19:00;240;125;115
streda;24.6.2020;20:00;161;69;92
streda;24.6.2020;21:00;62;32;30
streda;24.6.2020;22:00;16;10;6
streda;24.6.2020;23:00;10;7;3
štvrtok;25.6.2020;0:00;6;2;4
štvrtok;25.6.2020;1:00;0;0;0
štvrtok;25.6.2020;2:00;0;0;0
štvrtok;25.6.2020;3:00;0;0;0
štvrtok;25.6.2020;4:00;1;0;1
štvrtok;25.6.2020;5:00;17;8;9
štvrtok;25.6.2020;6:00;61;37;24
štvrtok;25.6.2020;7:00;109;47;62
štvrtok;25.6.2020;8:00;106;62;44
štvrtok;25.6.2020;9:00;63;33;30
štvrtok;25.6.2020;10:00;72;44;28
štvrtok;25.6.2020;11:00;75;48;27
štvrtok;25.6.2020;12:00;84;43;41
štvrtok;25.6.2020;13:00;74;46;28
štvrtok;25.6.2020;14:00;140;77;63
štvrtok;25.6.2020;15:00;166;81;85
štvrtok;25.6.2020;16:00;243;138;105
štvrtok;25.6.2020;17:00;346;221;125
štvrtok;25.6.2020;18:00;232;132;100
štvrtok;25.6.2020;19:00;209;97;112
štvrtok;25.6.2020;20:00;118;58;60
štvrtok;25.6.2020;21:00;42;24;18
štvrtok;25.6.2020;22:00;19;11;8
štvrtok;25.6.2020;23:00;9;5;4
piatok;26.6.2020;0:00;3;2;1
piatok;26.6.2020;1:00;1;0;1
piatok;26.6.2020;2:00;0;0;0
piatok;26.6.2020;3:00;0;0;0
piatok;26.6.2020;4:00;0;0;0
piatok;26.6.2020;5:00;2;0;2
piatok;26.6.2020;6:00;11;6;5
piatok;26.6.2020;7:00;40;16;24
piatok;26.6.2020;8:00;56;26;30
piatok;26.6.2020;9:00;55;33;22
piatok;26.6.2020;10:00;71;50;21
piatok;26.6.2020;11:00;79;48;31
piatok;26.6.2020;12:00;86;36;50
piatok;26.6.2020;13:00;86;41;45
piatok;26.6.2020;14:00;106;75;31
piatok;26.6.2020;15:00;124;66;58
piatok;26.6.2020;16:00;193;99;94
piatok;26.6.2020;17:00;195;108;87
piatok;26.6.2020;18:00;159;90;69
piatok;26.6.2020;19:00;126;65;61
piatok;26.6.2020;20:00;279;228;51
piatok;26.6.2020;21:00;108;45;63
piatok;26.6.2020;22:00;43;8;35
piatok;26.6.2020;23:00;20;10;10
sobota;27.6.2020;0:00;37;11;26
sobota;27.6.2020;1:00;13;0;13
sobota;27.6.2020;2:00;10;4;6
sobota;27.6.2020;3:00;4;0;4
sobota;27.6.2020;4:00;5;3;2
sobota;27.6.2020;5:00;14;10;4
sobota;27.6.2020;6:00;25;16;9
sobota;27.6.2020;7:00;52;44;8
sobota;27.6.2020;8:00;91;57;34
sobota;27.6.2020;9:00;137;100;37
sobota;27.6.2020;10:00;282;205;77
sobota;27.6.2020;11:00;316;178;138
sobota;27.6.2020;12:00;262;144;118
sobota;27.6.2020;13:00;244;146;98
sobota;27.6.2020;14:00;229;112;117
sobota;27.6.2020;15:00;342;166;176
sobota;27.6.2020;16:00;321;167;154
sobota;27.6.2020;17:00;301;123;178
sobota;27.6.2020;18:00;250;128;122
sobota;27.6.2020;19:00;214;96;118
sobota;27.6.2020;20:00;138;74;64
sobota;27.6.2020;21:00;75;47;28
sobota;27.6.2020;22:00;18;9;9
sobota;27.6.2020;23:00;15;9;6
nede?a;28.6.2020;0:00;8;6;2
nede?a;28.6.2020;1:00;6;0;6
nede?a;28.6.2020;2:00;4;3;1
nede?a;28.6.2020;3:00;5;5;0
nede?a;28.6.2020;4:00;1;0;1
nede?a;28.6.2020;5:00;10;4;6
nede?a;28.6.2020;6:00;23;16;7
nede?a;28.6.2020;7:00;45;34;11
nede?a;28.6.2020;8:00;95;69;26
nede?a;28.6.2020;9:00;218;135;83
nede?a;28.6.2020;10:00;276;156;120
nede?a;28.6.2020;11:00;257;126;131
nede?a;28.6.2020;12:00;201;99;102
nede?a;28.6.2020;13:00;207;107;100
nede?a;28.6.2020;14:00;216;124;92
nede?a;28.6.2020;15:00;219;110;109
nede?a;28.6.2020;16:00;261;140;121
nede?a;28.6.2020;17:00;284;152;132
nede?a;28.6.2020;18:00;231;122;109
nede?a;28.6.2020;19:00;219;125;94
nede?a;28.6.2020;20:00;138;74;64
nede?a;28.6.2020;21:00;57;36;21
nede?a;28.6.2020;22:00;27;19;8
nede?a;28.6.2020;23:00;11;8;3
pondelok;29.6.2020;0:00;0;0;0
pondelok;29.6.2020;1:00;0;0;0
pondelok;29.6.2020;2:00;1;1;0
pondelok;29.6.2020;3:00;0;0;0
pondelok;29.6.2020;4:00;2;1;1
pondelok;29.6.2020;5:00;9;3;6
pondelok;29.6.2020;6:00;27;18;9
pondelok;29.6.2020;7:00;47;24;23
pondelok;29.6.2020;8:00;51;29;22
pondelok;29.6.2020;9:00;46;25;21
pondelok;29.6.2020;10:00;40;23;17
pondelok;29.6.2020;11:00;49;34;15
pondelok;29.6.2020;12:00;31;18;13
pondelok;29.6.2020;13:00;32;14;18
pondelok;29.6.2020;14:00;26;11;15
pondelok;29.6.2020;15:00;19;11;8
pondelok;29.6.2020;16:00;19;7;12
pondelok;29.6.2020;17:00;32;16;16
pondelok;29.6.2020;18:00;33;19;14
pondelok;29.6.2020;19:00;61;33;28
pondelok;29.6.2020;20:00;82;45;37
pondelok;29.6.2020;21:00;37;25;12
pondelok;29.6.2020;22:00;14;7;7
pondelok;29.6.2020;23:00;3;2;1
utorok;30.6.2020;0:00;0;0;0
utorok;30.6.2020;1:00;0;0;0
utorok;30.6.2020;2:00;0;0;0
utorok;30.6.2020;3:00;0;0;0
utorok;30.6.2020;4:00;2;1;1
utorok;30.6.2020;5:00;28;21;7
utorok;30.6.2020;6:00;57;38;19
utorok;30.6.2020;7:00;83;46;37
utorok;30.6.2020;8:00;94;55;39
utorok;30.6.2020;9:00;94;46;48
utorok;30.6.2020;10:00;92;60;32
utorok;30.6.2020;11:00;102;55;47
utorok;30.6.2020;12:00;75;43;32
utorok;30.6.2020;13:00;93;49;44
utorok;30.6.2020;14:00;122;62;60
utorok;30.6.2020;15:00;166;95;71
utorok;30.6.2020;16:00;288;161;127
utorok;30.6.2020;17:00;431;263;168
utorok;30.6.2020;18:00;405;226;179
utorok;30.6.2020;19:00;354;169;185
utorok;30.6.2020;20:00;187;93;94
utorok;30.6.2020;21:00;106;61;45
utorok;30.6.2020;22:00;24;17;7
utorok;30.6.2020;23:00;23;14;9
streda;1.7.2020;0:00;8;3;5
streda;1.7.2020;1:00;2;1;1
streda;1.7.2020;2:00;1;0;1
streda;1.7.2020;3:00;1;0;1
streda;1.7.2020;4:00;4;2;2
streda;1.7.2020;5:00;18;10;8
streda;1.7.2020;6:00;66;39;27
streda;1.7.2020;7:00;98;44;54
streda;1.7.2020;8:00;120;66;54
streda;1.7.2020;9:00;83;51;32
streda;1.7.2020;10:00;100;49;51
streda;1.7.2020;11:00;97;47;50
streda;1.7.2020;12:00;90;48;42
streda;1.7.2020;13:00;109;58;51
streda;1.7.2020;14:00;92;43;49
streda;1.7.2020;15:00;133;79;54
streda;1.7.2020;16:00;239;145;94
streda;1.7.2020;17:00;343;229;114
streda;1.7.2020;18:00;329;168;161
streda;1.7.2020;19:00;299;141;158
streda;1.7.2020;20:00;123;59;64
streda;1.7.2020;21:00;53;33;20
streda;1.7.2020;22:00;22;7;15
streda;1.7.2020;23:00;4;3;1
štvrtok;2.7.2020;0:00;1;1;0
štvrtok;2.7.2020;1:00;2;0;2
štvrtok;2.7.2020;2:00;1;1;0
štvrtok;2.7.2020;3:00;0;0;0
štvrtok;2.7.2020;4:00;2;1;1
štvrtok;2.7.2020;5:00;18;12;6
štvrtok;2.7.2020;6:00;66;45;21
štvrtok;2.7.2020;7:00;97;52;45
štvrtok;2.7.2020;8:00;105;55;50
štvrtok;2.7.2020;9:00;92;49;43
štvrtok;2.7.2020;10:00;76;40;36
štvrtok;2.7.2020;11:00;89;52;37
štvrtok;2.7.2020;12:00;58;27;31
štvrtok;2.7.2020;13:00;75;42;33
štvrtok;2.7.2020;14:00;95;46;49
štvrtok;2.7.2020;15:00;127;75;52
štvrtok;2.7.2020;16:00;221;116;105
štvrtok;2.7.2020;17:00;368;241;127
štvrtok;2.7.2020;18:00;261;133;128
štvrtok;2.7.2020;19:00;231;113;118
štvrtok;2.7.2020;20:00;117;63;54
štvrtok;2.7.2020;21:00;55;29;26
štvrtok;2.7.2020;22:00;20;15;5
štvrtok;2.7.2020;23:00;5;2;3
piatok;3.7.2020;0:00;2;0;2
piatok;3.7.2020;1:00;2;1;1
piatok;3.7.2020;2:00;0;0;0
piatok;3.7.2020;3:00;0;0;0
piatok;3.7.2020;4:00;2;1;1
piatok;3.7.2020;5:00;6;2;4
piatok;3.7.2020;6:00;26;13;13
piatok;3.7.2020;7:00;56;28;28
piatok;3.7.2020;8:00;49;24;25
piatok;3.7.2020;9:00;30;18;12
piatok;3.7.2020;10:00;27;13;14
piatok;3.7.2020;11:00;12;6;6
piatok;3.7.2020;12:00;17;8;9
piatok;3.7.2020;13:00;37;19;18
piatok;3.7.2020;14:00;57;29;28
piatok;3.7.2020;15:00;87;48;39
piatok;3.7.2020;16:00;161;102;59
piatok;3.7.2020;17:00;191;107;84
piatok;3.7.2020;18:00;142;79;63
piatok;3.7.2020;19:00;150;71;79
piatok;3.7.2020;20:00;119;59;60
piatok;3.7.2020;21:00;43;26;17
piatok;3.7.2020;22:00;14;7;7
piatok;3.7.2020;23:00;6;5;1
sobota;4.7.2020;0:00;2;1;1
sobota;4.7.2020;1:00;3;1;2
sobota;4.7.2020;2:00;0;0;0
sobota;4.7.2020;3:00;0;0;0
sobota;4.7.2020;4:00;1;0;1
sobota;4.7.2020;5:00;14;11;3
sobota;4.7.2020;6:00;19;12;7
sobota;4.7.2020;7:00;31;18;13
sobota;4.7.2020;8:00;113;68;45
sobota;4.7.2020;9:00;187;124;63
sobota;4.7.2020;10:00;240;144;96
sobota;4.7.2020;11:00;275;178;97
sobota;4.7.2020;12:00;205;88;117
sobota;4.7.2020;13:00;237;108;129
sobota;4.7.2020;14:00;246;119;127
sobota;4.7.2020;15:00;242;148;94
sobota;4.7.2020;16:00;251;134;117
sobota;4.7.2020;17:00;242;136;106
sobota;4.7.2020;18:00;213;112;101
sobota;4.7.2020;19:00;202;92;110
sobota;4.7.2020;20:00;142;59;83
sobota;4.7.2020;21:00;68;44;24
sobota;4.7.2020;22:00;12;7;5
sobota;4.7.2020;23:00;11;8;3
nede?a;5.7.2020;0:00;6;6;0
nede?a;5.7.2020;1:00;3;0;3
nede?a;5.7.2020;2:00;0;0;0
nede?a;5.7.2020;3:00;3;3;0
nede?a;5.7.2020;4:00;1;1;0
nede?a;5.7.2020;5:00;2;2;0
nede?a;5.7.2020;6:00;32;23;9
nede?a;5.7.2020;7:00;53;33;20
nede?a;5.7.2020;8:00;109;69;40
nede?a;5.7.2020;9:00;184;107;77
nede?a;5.7.2020;10:00;278;193;85
nede?a;5.7.2020;11:00;222;129;93
nede?a;5.7.2020;12:00;229;107;122
nede?a;5.7.2020;13:00;210;85;125
nede?a;5.7.2020;14:00;249;117;132
nede?a;5.7.2020;15:00;200;103;97
nede?a;5.7.2020;16:00;259;135;124
nede?a;5.7.2020;17:00;300;156;144
nede?a;5.7.2020;18:00;278;166;112
nede?a;5.7.2020;19:00;202;113;89
nede?a;5.7.2020;20:00;158;93;65
nede?a;5.7.2020;21:00;75;46;29
nede?a;5.7.2020;22:00;13;9;4
nede?a;5.7.2020;23:00;6;2;4
pondelok;6.7.2020;0:00;1;0;1
pondelok;6.7.2020;1:00;1;1;0
pondelok;6.7.2020;2:00;0;0;0
pondelok;6.7.2020;3:00;1;0;1
pondelok;6.7.2020;4:00;3;0;3
pondelok;6.7.2020;5:00;17;10;7
pondelok;6.7.2020;6:00;59;28;31
pondelok;6.7.2020;7:00;78;39;39
pondelok;6.7.2020;8:00;100;53;47
pondelok;6.7.2020;9:00;60;32;28
pondelok;6.7.2020;10:00;88;47;41
pondelok;6.7.2020;11:00;76;42;34
pondelok;6.7.2020;12:00;70;38;32
pondelok;6.7.2020;13:00;60;29;31
pondelok;6.7.2020;14:00;65;34;31
pondelok;6.7.2020;15:00;147;70;77
pondelok;6.7.2020;16:00;184;96;88
pondelok;6.7.2020;17:00;208;102;106
pondelok;6.7.2020;18:00;217;126;91
pondelok;6.7.2020;19:00;140;82;58
pondelok;6.7.2020;20:00;87;56;31
pondelok;6.7.2020;21:00;28;11;17
pondelok;6.7.2020;22:00;8;4;4
pondelok;6.7.2020;23:00;4;1;3
utorok;7.7.2020;0:00;0;0;0
utorok;7.7.2020;1:00;1;0;1
utorok;7.7.2020;2:00;0;0;0
utorok;7.7.2020;3:00;2;0;2
utorok;7.7.2020;4:00;4;2;2
utorok;7.7.2020;5:00;13;5;8
utorok;7.7.2020;6:00;50;22;28
utorok;7.7.2020;7:00;72;32;40
utorok;7.7.2020;8:00;87;44;43
utorok;7.7.2020;9:00;56;26;30
utorok;7.7.2020;10:00;56;33;23
utorok;7.7.2020;11:00;59;36;23
utorok;7.7.2020;12:00;47;25;22
utorok;7.7.2020;13:00;50;22;28
utorok;7.7.2020;14:00;103;65;38
utorok;7.7.2020;15:00;148;98;50
utorok;7.7.2020;16:00;187;107;80
utorok;7.7.2020;17:00;335;199;136
utorok;7.7.2020;18:00;260;145;115
utorok;7.7.2020;19:00;242;116;126
utorok;7.7.2020;20:00;141;88;53
utorok;7.7.2020;21:00;55;29;26
utorok;7.7.2020;22:00;15;8;7
utorok;7.7.2020;23:00;9;7;2
streda;8.7.2020;0:00;8;7;1
streda;8.7.2020;1:00;1;1;0
streda;8.7.2020;2:00;0;0;0
streda;8.7.2020;3:00;0;0;0
streda;8.7.2020;4:00;2;1;1
streda;8.7.2020;5:00;15;6;9
streda;8.7.2020;6:00;47;23;24
streda;8.7.2020;7:00;102;56;46
streda;8.7.2020;8:00;115;59;56
streda;8.7.2020;9:00;91;48;43
streda;8.7.2020;10:00;81;41;40
streda;8.7.2020;11:00;122;71;51
streda;8.7.2020;12:00;87;50;37
streda;8.7.2020;13:00;96;44;52
streda;8.7.2020;14:00;142;74;68
streda;8.7.2020;15:00;193;113;80
streda;8.7.2020;16:00;267;157;110
streda;8.7.2020;17:00;435;288;147
streda;8.7.2020;18:00;336;196;140
streda;8.7.2020;19:00;318;128;190
streda;8.7.2020;20:00;217;122;95
streda;8.7.2020;21:00;81;35;46
streda;8.7.2020;22:00;17;7;10
streda;8.7.2020;23:00;14;9;5
štvrtok;9.7.2020;0:00;9;7;2
štvrtok;9.7.2020;1:00;0;0;0
štvrtok;9.7.2020;2:00;1;0;1
štvrtok;9.7.2020;3:00;0;0;0
štvrtok;9.7.2020;4:00;3;1;2
štvrtok;9.7.2020;5:00;14;8;6
štvrtok;9.7.2020;6:00;82;54;28
štvrtok;9.7.2020;7:00;98;42;56
štvrtok;9.7.2020;8:00;87;48;39
štvrtok;9.7.2020;9:00;88;46;42
štvrtok;9.7.2020;10:00;94;56;38
štvrtok;9.7.2020;11:00;63;32;31
štvrtok;9.7.2020;12:00;79;46;33
štvrtok;9.7.2020;13:00;63;35;28
štvrtok;9.7.2020;14:00;116;60;56
štvrtok;9.7.2020;15:00;135;76;59
štvrtok;9.7.2020;16:00;221;118;103
štvrtok;9.7.2020;17:00;353;210;143
štvrtok;9.7.2020;18:00;317;178;139
štvrtok;9.7.2020;19:00;254;125;129
štvrtok;9.7.2020;20:00;170;102;68
štvrtok;9.7.2020;21:00;73;35;38
štvrtok;9.7.2020;22:00;14;4;10
štvrtok;9.7.2020;23:00;8;4;4
piatok;10.7.2020;0:00;0;0;0
piatok;10.7.2020;1:00;0;0;0
piatok;10.7.2020;2:00;0;0;0
piatok;10.7.2020;3:00;0;0;0
piatok;10.7.2020;4:00;2;1;1
piatok;10.7.2020;5:00;18;11;7
piatok;10.7.2020;6:00;60;36;24
piatok;10.7.2020;7:00;74;42;32
piatok;10.7.2020;8:00;120;75;45
piatok;10.7.2020;9:00;89;45;44
piatok;10.7.2020;10:00;80;39;41
piatok;10.7.2020;11:00;97;44;53
piatok;10.7.2020;12:00;83;47;36
piatok;10.7.2020;13:00;67;33;34
piatok;10.7.2020;14:00;118;49;69
piatok;10.7.2020;15:00;132;74;58
piatok;10.7.2020;16:00;175;81;94
piatok;10.7.2020;17:00;207;105;102
piatok;10.7.2020;18:00;191;104;87
piatok;10.7.2020;19:00;219;127;92
piatok;10.7.2020;20:00;151;81;70
piatok;10.7.2020;21:00;77;41;36
piatok;10.7.2020;22:00;22;12;10
piatok;10.7.2020;23:00;14;11;3
sobota;11.7.2020;0:00;1;1;0
sobota;11.7.2020;1:00;5;1;4
sobota;11.7.2020;2:00;3;3;0
sobota;11.7.2020;3:00;0;0;0
sobota;11.7.2020;4:00;3;0;3
sobota;11.7.2020;5:00;6;3;3
sobota;11.7.2020;6:00;13;5;8
sobota;11.7.2020;7:00;37;23;14
sobota;11.7.2020;8:00;71;47;24
sobota;11.7.2020;9:00;106;70;36
sobota;11.7.2020;10:00;136;79;57
sobota;11.7.2020;11:00;140;72;68
sobota;11.7.2020;12:00;113;47;66
sobota;11.7.2020;13:00;60;30;30
sobota;11.7.2020;14:00;26;7;19
sobota;11.7.2020;15:00;10;2;8
sobota;11.7.2020;16:00;26;12;14
sobota;11.7.2020;17:00;11;5;6
sobota;11.7.2020;18:00;3;2;1
sobota;11.7.2020;19:00;4;0;4
sobota;11.7.2020;20:00;5;3;2
sobota;11.7.2020;21:00;3;2;1
sobota;11.7.2020;22:00;5;3;2
sobota;11.7.2020;23:00;3;3;0
nede?a;12.7.2020;0:00;2;1;1
nede?a;12.7.2020;1:00;1;1;0
nede?a;12.7.2020;2:00;0;0;0
nede?a;12.7.2020;3:00;0;0;0
nede?a;12.7.2020;4:00;0;0;0
nede?a;12.7.2020;5:00;3;1;2
nede?a;12.7.2020;6:00;11;8;3
nede?a;12.7.2020;7:00;13;7;6
nede?a;12.7.2020;8:00;57;39;18
nede?a;12.7.2020;9:00;112;79;33
nede?a;12.7.2020;10:00;222;176;46
nede?a;12.7.2020;11:00;238;136;102
nede?a;12.7.2020;12:00;206;102;104
nede?a;12.7.2020;13:00;190;95;95
nede?a;12.7.2020;14:00;273;155;118
nede?a;12.7.2020;15:00;290;169;121
nede?a;12.7.2020;16:00;308;146;162
nede?a;12.7.2020;17:00;324;174;150
nede?a;12.7.2020;18:00;298;154;144
nede?a;12.7.2020;19:00;199;106;93
nede?a;12.7.2020;20:00;104;48;56
nede?a;12.7.2020;21:00;39;23;16
nede?a;12.7.2020;22:00;7;4;3
nede?a;12.7.2020;23:00;3;2;1
pondelok;13.7.2020;0:00;2;1;1
pondelok;13.7.2020;1:00;1;0;1
pondelok;13.7.2020;2:00;0;0;0
pondelok;13.7.2020;3:00;0;0;0
pondelok;13.7.2020;4:00;2;2;0
pondelok;13.7.2020;5:00;10;4;6
pondelok;13.7.2020;6:00;47;31;16
pondelok;13.7.2020;7:00;69;33;36
pondelok;13.7.2020;8:00;87;44;43
pondelok;13.7.2020;9:00;79;59;20
pondelok;13.7.2020;10:00;46;21;25
pondelok;13.7.2020;11:00;70;37;33
pondelok;13.7.2020;12:00;67;27;40
pondelok;13.7.2020;13:00;70;38;32
pondelok;13.7.2020;14:00;83;37;46
pondelok;13.7.2020;15:00;135;72;63
pondelok;13.7.2020;16:00;211;110;101
pondelok;13.7.2020;17:00;312;189;123
pondelok;13.7.2020;18:00;279;154;125
pondelok;13.7.2020;19:00;214;118;96
pondelok;13.7.2020;20:00;140;73;67
pondelok;13.7.2020;21:00;49;20;29
pondelok;13.7.2020;22:00;14;8;6
pondelok;13.7.2020;23:00;8;6;2
utorok;14.7.2020;0:00;2;0;2
utorok;14.7.2020;1:00;0;0;0
utorok;14.7.2020;2:00;1;0;1
utorok;14.7.2020;3:00;0;0;0
utorok;14.7.2020;4:00;1;1;0
utorok;14.7.2020;5:00;15;10;5
utorok;14.7.2020;6:00;66;43;23
utorok;14.7.2020;7:00;98;44;54
utorok;14.7.2020;8:00;111;61;50
utorok;14.7.2020;9:00;98;45;53
utorok;14.7.2020;10:00;99;55;44
utorok;14.7.2020;11:00;81;43;38
utorok;14.7.2020;12:00;94;42;52
utorok;14.7.2020;13:00;95;46;49
utorok;14.7.2020;14:00;115;64;51
utorok;14.7.2020;15:00;164;89;75
utorok;14.7.2020;16:00;277;140;137
utorok;14.7.2020;17:00;418;255;163
utorok;14.7.2020;18:00;357;201;156
utorok;14.7.2020;19:00;278;134;144
utorok;14.7.2020;20:00;188;101;87
utorok;14.7.2020;21:00;68;32;36
utorok;14.7.2020;22:00;21;10;11
utorok;14.7.2020;23:00;7;3;4
streda;15.7.2020;0:00;2;1;1
streda;15.7.2020;1:00;0;0;0
streda;15.7.2020;2:00;2;2;0
streda;15.7.2020;3:00;0;0;0
streda;15.7.2020;4:00;3;2;1
streda;15.7.2020;5:00;10;5;5
streda;15.7.2020;6:00;46;30;16
streda;15.7.2020;7:00;79;36;43
streda;15.7.2020;8:00;108;70;38
streda;15.7.2020;9:00;108;59;49
streda;15.7.2020;10:00;93;45;48
streda;15.7.2020;11:00;74;41;33
streda;15.7.2020;12:00;81;40;41
streda;15.7.2020;13:00;75;40;35
streda;15.7.2020;14:00;99;55;44
streda;15.7.2020;15:00;154;79;75
streda;15.7.2020;16:00;286;163;123
streda;15.7.2020;17:00;390;250;140
streda;15.7.2020;18:00;290;168;122
streda;15.7.2020;19:00;284;124;160
streda;15.7.2020;20:00;131;53;78
streda;15.7.2020;21:00;52;40;12
streda;15.7.2020;22:00;28;19;9
streda;15.7.2020;23:00;7;4;3
štvrtok;16.7.2020;0:00;7;5;2
štvrtok;16.7.2020;1:00;1;1;0
štvrtok;16.7.2020;2:00;1;0;1
štvrtok;16.7.2020;3:00;0;0;0
štvrtok;16.7.2020;4:00;1;1;0
štvrtok;16.7.2020;5:00;11;5;6
štvrtok;16.7.2020;6:00;16;7;9
štvrtok;16.7.2020;7:00;34;16;18
štvrtok;16.7.2020;8:00;55;27;28
štvrtok;16.7.2020;9:00;44;22;22
štvrtok;16.7.2020;10:00;30;18;12
štvrtok;16.7.2020;11:00;26;14;12
štvrtok;16.7.2020;12:00;37;12;25
štvrtok;16.7.2020;13:00;44;25;19
štvrtok;16.7.2020;14:00;68;37;31
štvrtok;16.7.2020;15:00;87;43;44
štvrtok;16.7.2020;16:00;132;75;57
štvrtok;16.7.2020;17:00;229;146;83
štvrtok;16.7.2020;18:00;158;90;68
štvrtok;16.7.2020;19:00;153;63;90
štvrtok;16.7.2020;20:00;61;31;30
štvrtok;16.7.2020;21:00;22;9;13
štvrtok;16.7.2020;22:00;6;5;1
štvrtok;16.7.2020;23:00;1;1;0
piatok;17.7.2020;0:00;1;0;1
piatok;17.7.2020;1:00;0;0;0
piatok;17.7.2020;2:00;0;0;0
piatok;17.7.2020;3:00;0;0;0
piatok;17.7.2020;4:00;1;0;1
piatok;17.7.2020;5:00;7;2;5
piatok;17.7.2020;6:00;25;19;6
piatok;17.7.2020;7:00;49;19;30
piatok;17.7.2020;8:00;102;73;29
piatok;17.7.2020;9:00;51;29;22
piatok;17.7.2020;10:00;62;36;26
piatok;17.7.2020;11:00;59;41;18
piatok;17.7.2020;12:00;78;38;40
piatok;17.7.2020;13:00;69;41;28
piatok;17.7.2020;14:00;128;71;57
piatok;17.7.2020;15:00;126;62;64
piatok;17.7.2020;16:00;145;81;64
piatok;17.7.2020;17:00;182;106;76
piatok;17.7.2020;18:00;173;88;85
piatok;17.7.2020;19:00;141;63;78
piatok;17.7.2020;20:00;73;39;34
piatok;17.7.2020;21:00;20;10;10
piatok;17.7.2020;22:00;28;4;24
piatok;17.7.2020;23:00;16;3;13
sobota;18.7.2020;0:00;3;3;0
sobota;18.7.2020;1:00;1;1;0
sobota;18.7.2020;2:00;1;1;0
sobota;18.7.2020;3:00;1;1;0
sobota;18.7.2020;4:00;0;0;0
sobota;18.7.2020;5:00;1;1;0
sobota;18.7.2020;6:00;1;0;1
sobota;18.7.2020;7:00;0;0;0
sobota;18.7.2020;8:00;1;1;0
sobota;18.7.2020;9:00;6;2;4
sobota;18.7.2020;10:00;16;8;8
sobota;18.7.2020;11:00;17;11;6
sobota;18.7.2020;12:00;23;15;8
sobota;18.7.2020;13:00;56;41;15
sobota;18.7.2020;14:00;60;37;23
sobota;18.7.2020;15:00;150;82;68
sobota;18.7.2020;16:00;123;72;51
sobota;18.7.2020;17:00;126;60;66
sobota;18.7.2020;18:00;107;39;68
sobota;18.7.2020;19:00;52;26;26
sobota;18.7.2020;20:00;38;19;19
sobota;18.7.2020;21:00;7;5;2
sobota;18.7.2020;22:00;7;5;2
sobota;18.7.2020;23:00;0;0;0
nede?a;19.7.2020;0:00;3;2;1
nede?a;19.7.2020;1:00;1;0;1
nede?a;19.7.2020;2:00;2;2;0
nede?a;19.7.2020;3:00;1;1;0
nede?a;19.7.2020;4:00;1;0;1
nede?a;19.7.2020;5:00;3;3;0
nede?a;19.7.2020;6:00;8;8;0
nede?a;19.7.2020;7:00;16;14;2
nede?a;19.7.2020;8:00;41;27;14
nede?a;19.7.2020;9:00;81;58;23
nede?a;19.7.2020;10:00;138;97;41
nede?a;19.7.2020;11:00;160;105;55
nede?a;19.7.2020;12:00;123;50;73
nede?a;19.7.2020;13:00;82;37;45
nede?a;19.7.2020;14:00;157;98;59
nede?a;19.7.2020;15:00;219;131;88
nede?a;19.7.2020;16:00;188;105;83
nede?a;19.7.2020;17:00;174;78;96
nede?a;19.7.2020;18:00;167;82;85
nede?a;19.7.2020;19:00;127;75;52
nede?a;19.7.2020;20:00;27;9;18
nede?a;19.7.2020;21:00;16;6;10
nede?a;19.7.2020;22:00;2;1;1
nede?a;19.7.2020;23:00;5;4;1
pondelok;20.7.2020;0:00;0;0;0
pondelok;20.7.2020;1:00;0;0;0
pondelok;20.7.2020;2:00;2;2;0
pondelok;20.7.2020;3:00;0;0;0
pondelok;20.7.2020;4:00;1;0;1
pondelok;20.7.2020;5:00;12;6;6
pondelok;20.7.2020;6:00;39;21;18
pondelok;20.7.2020;7:00;50;23;27
pondelok;20.7.2020;8:00;88;51;37
pondelok;20.7.2020;9:00;89;40;49
pondelok;20.7.2020;10:00;84;43;41
pondelok;20.7.2020;11:00;116;64;52
pondelok;20.7.2020;12:00;90;42;48
pondelok;20.7.2020;13:00;89;47;42
pondelok;20.7.2020;14:00;109;45;64
pondelok;20.7.2020;15:00;161;86;75
pondelok;20.7.2020;16:00;235;136;99
pondelok;20.7.2020;17:00;311;184;127
pondelok;20.7.2020;18:00;354;193;161
pondelok;20.7.2020;19:00;234;120;114
pondelok;20.7.2020;20:00;187;105;82
pondelok;20.7.2020;21:00;58;36;22
pondelok;20.7.2020;22:00;20;12;8
pondelok;20.7.2020;23:00;6;3;3
utorok;21.7.2020;0:00;0;0;0
utorok;21.7.2020;1:00;1;0;1
utorok;21.7.2020;2:00;0;0;0
utorok;21.7.2020;3:00;1;1;0
utorok;21.7.2020;4:00;3;1;2
utorok;21.7.2020;5:00;21;9;12
utorok;21.7.2020;6:00;72;37;35
utorok;21.7.2020;7:00;97;53;44
utorok;21.7.2020;8:00;124;56;68
utorok;21.7.2020;9:00;100;55;45
utorok;21.7.2020;10:00;100;49;51
utorok;21.7.2020;11:00;91;46;45
utorok;21.7.2020;12:00;99;46;53
utorok;21.7.2020;13:00;99;50;49
utorok;21.7.2020;14:00;101;46;55
utorok;21.7.2020;15:00;174;97;77
utorok;21.7.2020;16:00;233;126;107
utorok;21.7.2020;17:00;373;222;151
utorok;21.7.2020;18:00;204;129;75
utorok;21.7.2020;19:00;232;117;115
utorok;21.7.2020;20:00;175;86;89
utorok;21.7.2020;21:00;49;30;19
utorok;21.7.2020;22:00;14;10;4
utorok;21.7.2020;23:00;14;5;9
streda;22.7.2020;0:00;6;4;2
streda;22.7.2020;1:00;0;0;0
streda;22.7.2020;2:00;0;0;0
streda;22.7.2020;3:00;0;0;0
streda;22.7.2020;4:00;2;1;1
streda;22.7.2020;5:00;15;7;8
streda;22.7.2020;6:00;53;24;29
streda;22.7.2020;7:00;99;53;46
streda;22.7.2020;8:00;140;93;47
streda;22.7.2020;9:00;102;50;52
streda;22.7.2020;10:00;95;58;37
streda;22.7.2020;11:00;116;58;58
streda;22.7.2020;12:00;120;71;49
streda;22.7.2020;13:00;121;52;69
streda;22.7.2020;14:00;98;57;41
streda;22.7.2020;15:00;168;88;80
streda;22.7.2020;16:00;230;121;109
streda;22.7.2020;17:00;389;262;127
streda;22.7.2020;18:00;348;192;156
streda;22.7.2020;19:00;306;148;158
streda;22.7.2020;20:00;214;115;99
streda;22.7.2020;21:00;72;43;29
streda;22.7.2020;22:00;30;13;17
streda;22.7.2020;23:00;14;9;5
štvrtok;23.7.2020;0:00;5;3;2
štvrtok;23.7.2020;1:00;2;0;2
štvrtok;23.7.2020;2:00;2;2;0
štvrtok;23.7.2020;3:00;0;0;0
štvrtok;23.7.2020;4:00;1;1;0
štvrtok;23.7.2020;5:00;20;15;5
štvrtok;23.7.2020;6:00;55;26;29
štvrtok;23.7.2020;7:00;79;38;41
štvrtok;23.7.2020;8:00;108;59;49
štvrtok;23.7.2020;9:00;91;42;49
štvrtok;23.7.2020;10:00;108;66;42
štvrtok;23.7.2020;11:00;90;45;45
štvrtok;23.7.2020;12:00;91;46;45
štvrtok;23.7.2020;13:00;82;35;47
štvrtok;23.7.2020;14:00;106;45;61
štvrtok;23.7.2020;15:00;161;89;72
štvrtok;23.7.2020;16:00;204;105;99
štvrtok;23.7.2020;17:00;367;258;109
štvrtok;23.7.2020;18:00;357;207;150
štvrtok;23.7.2020;19:00;283;141;142
štvrtok;23.7.2020;20:00;182;92;90
štvrtok;23.7.2020;21:00;75;33;42
štvrtok;23.7.2020;22:00;13;10;3
štvrtok;23.7.2020;23:00;10;5;5
piatok;24.7.2020;0:00;3;2;1
piatok;24.7.2020;1:00;0;0;0
piatok;24.7.2020;2:00;0;0;0
piatok;24.7.2020;3:00;1;1;0
piatok;24.7.2020;4:00;1;0;1
piatok;24.7.2020;5:00;11;6;5
piatok;24.7.2020;6:00;40;27;13
piatok;24.7.2020;7:00;66;32;34
piatok;24.7.2020;8:00;89;54;35
piatok;24.7.2020;9:00;94;61;33
piatok;24.7.2020;10:00;83;33;50
piatok;24.7.2020;11:00;85;42;43
piatok;24.7.2020;12:00;99;46;53
piatok;24.7.2020;13:00;74;42;32
piatok;24.7.2020;14:00;90;51;39
piatok;24.7.2020;15:00;136;69;67
piatok;24.7.2020;16:00;223;102;121
piatok;24.7.2020;17:00;135;81;54
piatok;24.7.2020;18:00;77;26;51
piatok;24.7.2020;19:00;53;30;23
piatok;24.7.2020;20:00;42;13;29
piatok;24.7.2020;21:00;16;6;10
piatok;24.7.2020;22:00;8;7;1
piatok;24.7.2020;23:00;3;3;0
sobota;25.7.2020;0:00;1;0;1
sobota;25.7.2020;1:00;0;0;0
sobota;25.7.2020;2:00;3;3;0
sobota;25.7.2020;3:00;1;0;1
sobota;25.7.2020;4:00;2;0;2
sobota;25.7.2020;5:00;3;3;0
sobota;25.7.2020;6:00;6;5;1
sobota;25.7.2020;7:00;17;11;6
sobota;25.7.2020;8:00;20;14;6
sobota;25.7.2020;9:00;74;45;29
sobota;25.7.2020;10:00;106;67;39
sobota;25.7.2020;11:00;108;60;48
sobota;25.7.2020;12:00;117;54;63
sobota;25.7.2020;13:00;124;68;56
sobota;25.7.2020;14:00;48;32;16
sobota;25.7.2020;15:00;100;26;74
sobota;25.7.2020;16:00;86;49;37
sobota;25.7.2020;17:00;104;64;40
sobota;25.7.2020;18:00;85;40;45
sobota;25.7.2020;19:00;76;42;34
sobota;25.7.2020;20:00;75;32;43
sobota;25.7.2020;21:00;20;10;10
sobota;25.7.2020;22:00;8;5;3
sobota;25.7.2020;23:00;0;0;0
nede?a;26.7.2020;0:00;2;0;2
nede?a;26.7.2020;1:00;2;1;1
nede?a;26.7.2020;2:00;2;0;2
nede?a;26.7.2020;3:00;0;0;0
nede?a;26.7.2020;4:00;1;0;1
nede?a;26.7.2020;5:00;5;3;2
nede?a;26.7.2020;6:00;18;15;3
nede?a;26.7.2020;7:00;27;15;12
nede?a;26.7.2020;8:00;98;68;30
nede?a;26.7.2020;9:00;169;112;57
nede?a;26.7.2020;10:00;374;256;118
nede?a;26.7.2020;11:00;329;192;137
nede?a;26.7.2020;12:00;232;115;117
nede?a;26.7.2020;13:00;237;99;138
nede?a;26.7.2020;14:00;246;125;121
nede?a;26.7.2020;15:00;341;179;162
nede?a;26.7.2020;16:00;261;139;122
nede?a;26.7.2020;17:00;197;91;106
nede?a;26.7.2020;18:00;167;81;86
nede?a;26.7.2020;19:00;132;59;73
nede?a;26.7.2020;20:00;66;44;22
nede?a;26.7.2020;21:00;25;11;14
nede?a;26.7.2020;22:00;14;8;6
nede?a;26.7.2020;23:00;2;2;0
pondelok;27.7.2020;0:00;1;1;0
pondelok;27.7.2020;1:00;0;0;0
pondelok;27.7.2020;2:00;0;0;0
pondelok;27.7.2020;3:00;0;0;0
pondelok;27.7.2020;4:00;4;3;1
pondelok;27.7.2020;5:00;11;8;3
pondelok;27.7.2020;6:00;42;23;19
pondelok;27.7.2020;7:00;74;32;42
pondelok;27.7.2020;8:00;106;60;46
pondelok;27.7.2020;9:00;71;35;36
pondelok;27.7.2020;10:00;84;40;44
pondelok;27.7.2020;11:00;62;31;31
pondelok;27.7.2020;12:00;91;48;43
pondelok;27.7.2020;13:00;81;45;36
pondelok;27.7.2020;14:00;116;55;61
pondelok;27.7.2020;15:00;167;103;64
pondelok;27.7.2020;16:00;223;119;104
pondelok;27.7.2020;17:00;299;176;123
pondelok;27.7.2020;18:00;293;150;143
pondelok;27.7.2020;19:00;274;159;115
pondelok;27.7.2020;20:00;170;96;74
pondelok;27.7.2020;21:00;59;38;21
pondelok;27.7.2020;22:00;30;15;15
pondelok;27.7.2020;23:00;10;4;6
utorok;28.7.2020;0:00;7;5;2
utorok;28.7.2020;1:00;2;0;2
utorok;28.7.2020;2:00;1;1;0
utorok;28.7.2020;3:00;1;0;1
utorok;28.7.2020;4:00;5;4;1
utorok;28.7.2020;5:00;17;6;11
utorok;28.7.2020;6:00;73;46;27
utorok;28.7.2020;7:00;105;50;55
utorok;28.7.2020;8:00;137;74;63
utorok;28.7.2020;9:00;114;52;62
utorok;28.7.2020;10:00;98;48;50
utorok;28.7.2020;11:00;87;45;42
utorok;28.7.2020;12:00;71;30;41
utorok;28.7.2020;13:00;83;44;39
utorok;28.7.2020;14:00;86;53;33
utorok;28.7.2020;15:00;132;66;66
utorok;28.7.2020;16:00;205;107;98
utorok;28.7.2020;17:00;207;130;77
utorok;28.7.2020;18:00;255;142;113
utorok;28.7.2020;19:00;263;138;125
utorok;28.7.2020;20:00;172;92;80
utorok;28.7.2020;21:00;73;47;26
utorok;28.7.2020;22:00;13;8;5
utorok;28.7.2020;23:00;3;3;0
streda;29.7.2020;0:00;3;3;0
streda;29.7.2020;1:00;1;0;1
streda;29.7.2020;2:00;0;0;0
streda;29.7.2020;3:00;0;0;0
streda;29.7.2020;4:00;0;0;0
streda;29.7.2020;5:00;6;3;3
streda;29.7.2020;6:00;8;5;3
streda;29.7.2020;7:00;50;26;24
streda;29.7.2020;8:00;76;38;38
streda;29.7.2020;9:00;67;35;32
streda;29.7.2020;10:00;82;36;46
streda;29.7.2020;11:00;91;54;37
streda;29.7.2020;12:00;70;40;30
streda;29.7.2020;13:00;72;34;38
streda;29.7.2020;14:00;88;47;41
streda;29.7.2020;15:00;133;77;56
streda;29.7.2020;16:00;192;92;100
streda;29.7.2020;17:00;331;211;120
streda;29.7.2020;18:00;227;119;108
streda;29.7.2020;19:00;275;126;149
streda;29.7.2020;20:00;172;90;82
streda;29.7.2020;21:00;40;18;22
streda;29.7.2020;22:00;25;13;12
streda;29.7.2020;23:00;17;13;4
štvrtok;30.7.2020;0:00;5;5;0
štvrtok;30.7.2020;1:00;2;1;1
štvrtok;30.7.2020;2:00;0;0;0
štvrtok;30.7.2020;3:00;0;0;0
štvrtok;30.7.2020;4:00;2;2;0
štvrtok;30.7.2020;5:00;23;15;8
štvrtok;30.7.2020;6:00;67;36;31
štvrtok;30.7.2020;7:00;93;54;39
štvrtok;30.7.2020;8:00;87;55;32
štvrtok;30.7.2020;9:00;95;52;43
štvrtok;30.7.2020;10:00;80;41;39
štvrtok;30.7.2020;11:00;92;46;46
štvrtok;30.7.2020;12:00;67;35;32
štvrtok;30.7.2020;13:00;65;41;24
štvrtok;30.7.2020;14:00;101;47;54
štvrtok;30.7.2020;15:00;124;64;60
štvrtok;30.7.2020;16:00;163;82;81
štvrtok;30.7.2020;17:00;290;180;110
štvrtok;30.7.2020;18:00;277;155;122
štvrtok;30.7.2020;19:00;251;131;120
štvrtok;30.7.2020;20:00;218;118;100
štvrtok;30.7.2020;21:00;74;43;31
štvrtok;30.7.2020;22:00;31;15;16
štvrtok;30.7.2020;23:00;11;7;4
piatok;31.7.2020;0:00;0;0;0
piatok;31.7.2020;1:00;0;0;0
piatok;31.7.2020;2:00;2;2;0
piatok;31.7.2020;3:00;0;0;0
piatok;31.7.2020;4:00;3;2;1
piatok;31.7.2020;5:00;11;6;5
piatok;31.7.2020;6:00;45;23;22
piatok;31.7.2020;7:00;81;43;38
piatok;31.7.2020;8:00;98;45;53
piatok;31.7.2020;9:00;102;52;50
piatok;31.7.2020;10:00;95;59;36
piatok;31.7.2020;11:00;98;57;41
piatok;31.7.2020;12:00;78;41;37
piatok;31.7.2020;13:00;72;30;42
piatok;31.7.2020;14:00;133;54;79
piatok;31.7.2020;15:00;130;75;55
piatok;31.7.2020;16:00;148;72;76
piatok;31.7.2020;17:00;149;87;62
piatok;31.7.2020;18:00;176;102;74
piatok;31.7.2020;19:00;172;95;77
piatok;31.7.2020;20:00;109;54;55
piatok;31.7.2020;21:00;79;35;44
piatok;31.7.2020;22:00;33;18;15
piatok;31.7.2020;23:00;17;6;11
sobota;1.8.2020;0:00;10;1;9
sobota;1.8.2020;1:00;6;3;3
sobota;1.8.2020;2:00;2;1;1
sobota;1.8.2020;3:00;1;1;0
sobota;1.8.2020;4:00;2;1;1
sobota;1.8.2020;5:00;5;4;1
sobota;1.8.2020;6:00;30;23;7
sobota;1.8.2020;7:00;39;32;7
sobota;1.8.2020;8:00;88;64;24
sobota;1.8.2020;9:00;177;112;65
sobota;1.8.2020;10:00;165;93;72
sobota;1.8.2020;11:00;167;104;63
sobota;1.8.2020;12:00;188;109;79
sobota;1.8.2020;13:00;133;61;72
sobota;1.8.2020;14:00;126;63;63
sobota;1.8.2020;15:00;125;53;72
sobota;1.8.2020;16:00;132;78;54
sobota;1.8.2020;17:00;156;86;70
sobota;1.8.2020;18:00;183;90;93
sobota;1.8.2020;19:00;195;94;101
sobota;1.8.2020;20:00;138;71;67
sobota;1.8.2020;21:00;46;26;20
sobota;1.8.2020;22:00;37;12;25
sobota;1.8.2020;23:00;13;8;5
nede?a;2.8.2020;0:00;3;0;3
nede?a;2.8.2020;1:00;4;2;2
nede?a;2.8.2020;2:00;3;2;1
nede?a;2.8.2020;3:00;1;0;1
nede?a;2.8.2020;4:00;0;0;0
nede?a;2.8.2020;5:00;2;1;1
nede?a;2.8.2020;6:00;27;23;4
nede?a;2.8.2020;7:00;49;25;24
nede?a;2.8.2020;8:00;104;79;25
nede?a;2.8.2020;9:00;154;79;75
nede?a;2.8.2020;10:00;183;114;69
nede?a;2.8.2020;11:00;191;81;110
nede?a;2.8.2020;12:00;181;89;92
nede?a;2.8.2020;13:00;150;103;47
nede?a;2.8.2020;14:00;160;74;86
nede?a;2.8.2020;15:00;186;108;78
nede?a;2.8.2020;16:00;201;113;88
nede?a;2.8.2020;17:00;205;112;93
nede?a;2.8.2020;18:00;215;126;89
nede?a;2.8.2020;19:00;153;91;62
nede?a;2.8.2020;20:00;87;45;42
nede?a;2.8.2020;21:00;26;19;7
nede?a;2.8.2020;22:00;5;3;2
nede?a;2.8.2020;23:00;4;3;1
pondelok;3.8.2020;0:00;1;0;1
pondelok;3.8.2020;1:00;0;0;0
pondelok;3.8.2020;2:00;0;0;0
pondelok;3.8.2020;3:00;0;0;0
pondelok;3.8.2020;4:00;0;0;0
pondelok;3.8.2020;5:00;6;4;2
pondelok;3.8.2020;6:00;21;17;4
pondelok;3.8.2020;7:00;31;13;18
pondelok;3.8.2020;8:00;39;20;19
pondelok;3.8.2020;9:00;26;17;9
pondelok;3.8.2020;10:00;10;2;8
pondelok;3.8.2020;11:00;8;5;3
pondelok;3.8.2020;12:00;24;15;9
pondelok;3.8.2020;13:00;27;10;17
pondelok;3.8.2020;14:00;41;17;24
pondelok;3.8.2020;15:00;53;30;23
pondelok;3.8.2020;16:00;95;43;52
pondelok;3.8.2020;17:00;120;69;51
pondelok;3.8.2020;18:00;112;64;48
pondelok;3.8.2020;19:00;116;66;50
pondelok;3.8.2020;20:00;66;35;31
pondelok;3.8.2020;21:00;18;9;9
pondelok;3.8.2020;22:00;10;5;5
pondelok;3.8.2020;23:00;8;4;4
utorok;4.8.2020;0:00;3;1;2
utorok;4.8.2020;1:00;0;0;0
utorok;4.8.2020;2:00;0;0;0
utorok;4.8.2020;3:00;2;0;2
utorok;4.8.2020;4:00;1;1;0
utorok;4.8.2020;5:00;1;0;1
utorok;4.8.2020;6:00;14;8;6
utorok;4.8.2020;7:00;19;10;9
utorok;4.8.2020;8:00;45;23;22
utorok;4.8.2020;9:00;35;14;21
utorok;4.8.2020;10:00;19;8;11
utorok;4.8.2020;11:00;45;22;23
utorok;4.8.2020;12:00;33;15;18
utorok;4.8.2020;13:00;51;20;31
utorok;4.8.2020;14:00;70;37;33
utorok;4.8.2020;15:00;82;49;33
utorok;4.8.2020;16:00;115;72;43
utorok;4.8.2020;17:00;173;84;89
utorok;4.8.2020;18:00;72;49;23
utorok;4.8.2020;19:00;38;13;25
utorok;4.8.2020;20:00;21;8;13
utorok;4.8.2020;21:00;9;4;5
utorok;4.8.2020;22:00;5;3;2
utorok;4.8.2020;23:00;1;0;1
streda;5.8.2020;0:00;4;1;3
streda;5.8.2020;1:00;1;0;1
streda;5.8.2020;2:00;1;1;0
streda;5.8.2020;3:00;0;0;0
streda;5.8.2020;4:00;0;0;0
streda;5.8.2020;5:00;3;1;2
streda;5.8.2020;6:00;14;8;6
streda;5.8.2020;7:00;16;7;9
streda;5.8.2020;8:00;35;18;17
streda;5.8.2020;9:00;25;7;18
streda;5.8.2020;10:00;7;4;3
streda;5.8.2020;11:00;41;34;7
streda;5.8.2020;12:00;14;10;4
streda;5.8.2020;13:00;22;13;9
streda;5.8.2020;14:00;23;13;10
streda;5.8.2020;15:00;54;31;23
streda;5.8.2020;16:00;118;67;51
streda;5.8.2020;17:00;186;122;64
streda;5.8.2020;18:00;122;57;65
streda;5.8.2020;19:00;141;49;92
streda;5.8.2020;20:00;77;33;44
streda;5.8.2020;21:00;21;13;8
streda;5.8.2020;22:00;6;3;3
streda;5.8.2020;23:00;6;4;2
štvrtok;6.8.2020;0:00;3;1;2
štvrtok;6.8.2020;1:00;0;0;0
štvrtok;6.8.2020;2:00;0;0;0
štvrtok;6.8.2020;3:00;0;0;0
štvrtok;6.8.2020;4:00;1;0;1
štvrtok;6.8.2020;5:00;12;9;3
štvrtok;6.8.2020;6:00;48;27;21
štvrtok;6.8.2020;7:00;62;37;25
štvrtok;6.8.2020;8:00;94;43;51
štvrtok;6.8.2020;9:00;105;47;58
štvrtok;6.8.2020;10:00;114;66;48
štvrtok;6.8.2020;11:00;94;54;40
štvrtok;6.8.2020;12:00;100;61;39
štvrtok;6.8.2020;13:00;86;41;45
štvrtok;6.8.2020;14:00;95;44;51
štvrtok;6.8.2020;15:00;160;88;72
štvrtok;6.8.2020;16:00;237;130;107
štvrtok;6.8.2020;17:00;388;258;130
štvrtok;6.8.2020;18:00;320;176;144
štvrtok;6.8.2020;19:00;321;154;167
štvrtok;6.8.2020;20:00;184;94;90
štvrtok;6.8.2020;21:00;42;32;10
štvrtok;6.8.2020;22:00;21;9;12
štvrtok;6.8.2020;23:00;11;8;3
piatok;7.8.2020;0:00;0;0;0
piatok;7.8.2020;1:00;2;1;1
piatok;7.8.2020;2:00;4;3;1
piatok;7.8.2020;3:00;0;0;0
piatok;7.8.2020;4:00;1;1;0
piatok;7.8.2020;5:00;10;6;4
piatok;7.8.2020;6:00;40;29;11
piatok;7.8.2020;7:00;62;26;36
piatok;7.8.2020;8:00;106;52;54
piatok;7.8.2020;9:00;89;48;41
piatok;7.8.2020;10:00;88;35;53
piatok;7.8.2020;11:00;86;46;40
piatok;7.8.2020;12:00;85;41;44
piatok;7.8.2020;13:00;70;35;35
piatok;7.8.2020;14:00;87;39;48
piatok;7.8.2020;15:00;139;75;64
piatok;7.8.2020;16:00;206;99;107
piatok;7.8.2020;17:00;180;111;69
piatok;7.8.2020;18:00;210;116;94
piatok;7.8.2020;19:00;192;97;95
piatok;7.8.2020;20:00;118;59;59
piatok;7.8.2020;21:00;45;35;10
piatok;7.8.2020;22:00;14;9;5
piatok;7.8.2020;23:00;12;7;5
sobota;8.8.2020;0:00;5;2;3
sobota;8.8.2020;1:00;3;1;2
sobota;8.8.2020;2:00;0;0;0
sobota;8.8.2020;3:00;2;2;0
sobota;8.8.2020;4:00;1;0;1
sobota;8.8.2020;5:00;8;6;2
sobota;8.8.2020;6:00;26;19;7
sobota;8.8.2020;7:00;46;30;16
sobota;8.8.2020;8:00;93;64;29
sobota;8.8.2020;9:00;205;117;88
sobota;8.8.2020;10:00;220;124;96
sobota;8.8.2020;11:00;231;116;115
sobota;8.8.2020;12:00;140;53;87
sobota;8.8.2020;13:00;109;48;61
sobota;8.8.2020;14:00;121;49;72
sobota;8.8.2020;15:00;131;61;70
sobota;8.8.2020;16:00;167;88;79
sobota;8.8.2020;17:00;187;86;101
sobota;8.8.2020;18:00;161;94;67
sobota;8.8.2020;19:00;154;78;76
sobota;8.8.2020;20:00;112;54;58
sobota;8.8.2020;21:00;56;38;18
sobota;8.8.2020;22:00;20;12;8
sobota;8.8.2020;23:00;8;4;4
nede?a;9.8.2020;0:00;1;0;1
nede?a;9.8.2020;1:00;7;5;2
nede?a;9.8.2020;2:00;0;0;0
nede?a;9.8.2020;3:00;4;3;1
nede?a;9.8.2020;4:00;2;0;2
nede?a;9.8.2020;5:00;4;4;0
nede?a;9.8.2020;6:00;10;8;2
nede?a;9.8.2020;7:00;62;30;32
nede?a;9.8.2020;8:00;141;82;59
nede?a;9.8.2020;9:00;168;94;74
nede?a;9.8.2020;10:00;214;144;70
nede?a;9.8.2020;11:00;183;95;88
nede?a;9.8.2020;12:00;121;53;68
nede?a;9.8.2020;13:00;141;65;76
nede?a;9.8.2020;14:00;112;70;42
nede?a;9.8.2020;15:00;139;68;71
nede?a;9.8.2020;16:00;124;61;63
nede?a;9.8.2020;17:00;179;89;90
nede?a;9.8.2020;18:00;174;85;89
nede?a;9.8.2020;19:00;217;118;99
nede?a;9.8.2020;20:00;111;63;48
nede?a;9.8.2020;21:00;29;17;12
nede?a;9.8.2020;22:00;14;11;3
nede?a;9.8.2020;23:00;10;6;4
pondelok;10.8.2020;0:00;3;3;0
pondelok;10.8.2020;1:00;0;0;0
pondelok;10.8.2020;2:00;0;0;0
pondelok;10.8.2020;3:00;1;0;1
pondelok;10.8.2020;4:00;3;2;1
pondelok;10.8.2020;5:00;14;9;5
pondelok;10.8.2020;6:00;49;24;25
pondelok;10.8.2020;7:00;87;45;42
pondelok;10.8.2020;8:00;123;61;62
pondelok;10.8.2020;9:00;78;38;40
pondelok;10.8.2020;10:00;83;38;45
pondelok;10.8.2020;11:00;56;28;28
pondelok;10.8.2020;12:00;60;29;31
pondelok;10.8.2020;13:00;56;26;30
pondelok;10.8.2020;14:00;76;46;30
pondelok;10.8.2020;15:00;99;51;48
pondelok;10.8.2020;16:00;126;53;73
pondelok;10.8.2020;17:00;186;101;85
pondelok;10.8.2020;18:00;163;90;73
pondelok;10.8.2020;19:00;88;53;35
pondelok;10.8.2020;20:00;69;45;24
pondelok;10.8.2020;21:00;26;17;9
pondelok;10.8.2020;22:00;17;6;11
pondelok;10.8.2020;23:00;4;2;2
utorok;11.8.2020;0:00;2;2;0
utorok;11.8.2020;1:00;1;1;0
utorok;11.8.2020;2:00;0;0;0
utorok;11.8.2020;3:00;3;0;3
utorok;11.8.2020;4:00;1;1;0
utorok;11.8.2020;5:00;16;10;6
utorok;11.8.2020;6:00;54;32;22
utorok;11.8.2020;7:00;100;46;54
utorok;11.8.2020;8:00;107;59;48
utorok;11.8.2020;9:00;90;43;47
utorok;11.8.2020;10:00;61;36;25
utorok;11.8.2020;11:00;24;20;4
utorok;11.8.2020;12:00;27;17;10
utorok;11.8.2020;13:00;35;11;24
utorok;11.8.2020;14:00;82;41;41
utorok;11.8.2020;15:00;94;54;40
utorok;11.8.2020;16:00;207;127;80
utorok;11.8.2020;17:00;257;168;89
utorok;11.8.2020;18:00;214;135;79
utorok;11.8.2020;19:00;162;72;90
utorok;11.8.2020;20:00;51;22;29
utorok;11.8.2020;21:00;25;6;19
utorok;11.8.2020;22:00;6;3;3
utorok;11.8.2020;23:00;8;3;5
streda;12.8.2020;0:00;2;1;1
streda;12.8.2020;1:00;0;0;0
streda;12.8.2020;2:00;1;1;0
streda;12.8.2020;3:00;0;0;0
streda;12.8.2020;4:00;3;1;2
streda;12.8.2020;5:00;13;7;6
streda;12.8.2020;6:00;43;24;19
streda;12.8.2020;7:00;85;49;36
streda;12.8.2020;8:00;120;63;57
streda;12.8.2020;9:00;100;55;45
streda;12.8.2020;10:00;97;38;59
streda;12.8.2020;11:00;96;57;39
streda;12.8.2020;12:00;59;34;25
streda;12.8.2020;13:00;93;46;47
streda;12.8.2020;14:00;98;50;48
streda;12.8.2020;15:00;146;84;62
streda;12.8.2020;16:00;197;110;87
streda;12.8.2020;17:00;305;180;125
streda;12.8.2020;18:00;275;165;110
streda;12.8.2020;19:00;301;152;149
streda;12.8.2020;20:00;200;107;93
streda;12.8.2020;21:00;46;22;24
streda;12.8.2020;22:00;20;8;12
streda;12.8.2020;23:00;14;4;10
štvrtok;13.8.2020;0:00;7;7;0
štvrtok;13.8.2020;1:00;2;1;1
štvrtok;13.8.2020;2:00;0;0;0
štvrtok;13.8.2020;3:00;0;0;0
štvrtok;13.8.2020;4:00;3;1;2
štvrtok;13.8.2020;5:00;19;8;11
štvrtok;13.8.2020;6:00;44;27;17
štvrtok;13.8.2020;7:00;107;44;63
štvrtok;13.8.2020;8:00;116;61;55
štvrtok;13.8.2020;9:00;99;59;40
štvrtok;13.8.2020;10:00;95;56;39
štvrtok;13.8.2020;11:00;77;42;35
štvrtok;13.8.2020;12:00;77;33;44
štvrtok;13.8.2020;13:00;75;38;37
štvrtok;13.8.2020;14:00;91;52;39
štvrtok;13.8.2020;15:00;125;63;62
štvrtok;13.8.2020;16:00;179;99;80
štvrtok;13.8.2020;17:00;280;178;102
štvrtok;13.8.2020;18:00;104;56;48
štvrtok;13.8.2020;19:00;61;23;38
štvrtok;13.8.2020;20:00;43;24;19
štvrtok;13.8.2020;21:00;9;4;5
štvrtok;13.8.2020;22:00;5;4;1
štvrtok;13.8.2020;23:00;4;1;3
piatok;14.8.2020;0:00;3;2;1
piatok;14.8.2020;1:00;0;0;0
piatok;14.8.2020;2:00;0;0;0
piatok;14.8.2020;3:00;0;0;0
piatok;14.8.2020;4:00;1;1;0
piatok;14.8.2020;5:00;3;2;1
piatok;14.8.2020;6:00;29;23;6
piatok;14.8.2020;7:00;53;22;31
piatok;14.8.2020;8:00;71;35;36
piatok;14.8.2020;9:00;84;38;46
piatok;14.8.2020;10:00;90;52;38
piatok;14.8.2020;11:00;85;41;44
piatok;14.8.2020;12:00;79;47;32
piatok;14.8.2020;13:00;62;32;30
piatok;14.8.2020;14:00;95;56;39
piatok;14.8.2020;15:00;99;60;39
piatok;14.8.2020;16:00;174;103;71
piatok;14.8.2020;17:00;165;82;83
piatok;14.8.2020;18:00;183;109;74
piatok;14.8.2020;19:00;162;88;74
piatok;14.8.2020;20:00;84;35;49
piatok;14.8.2020;21:00;24;10;14
piatok;14.8.2020;22:00;10;7;3
piatok;14.8.2020;23:00;12;5;7
sobota;15.8.2020;0:00;4;1;3
sobota;15.8.2020;1:00;14;4;10
sobota;15.8.2020;2:00;2;1;1
sobota;15.8.2020;3:00;2;0;2
sobota;15.8.2020;4:00;0;0;0
sobota;15.8.2020;5:00;5;4;1
sobota;15.8.2020;6:00;13;9;4
sobota;15.8.2020;7:00;32;24;8
sobota;15.8.2020;8:00;110;63;47
sobota;15.8.2020;9:00;155;106;49
sobota;15.8.2020;10:00;202;125;77
sobota;15.8.2020;11:00;179;95;84
sobota;15.8.2020;12:00;183;101;82
sobota;15.8.2020;13:00;192;97;95
sobota;15.8.2020;14:00;217;101;116
sobota;15.8.2020;15:00;225;109;116
sobota;15.8.2020;16:00;195;92;103
sobota;15.8.2020;17:00;174;94;80
sobota;15.8.2020;18:00;155;72;83
sobota;15.8.2020;19:00;132;62;70
sobota;15.8.2020;20:00;46;24;22
sobota;15.8.2020;21:00;18;6;12
sobota;15.8.2020;22:00;10;3;7
sobota;15.8.2020;23:00;8;4;4
nede?a;16.8.2020;0:00;0;0;0
nede?a;16.8.2020;1:00;0;0;0
nede?a;16.8.2020;2:00;0;0;0
nede?a;16.8.2020;3:00;0;0;0
nede?a;16.8.2020;4:00;2;1;1
nede?a;16.8.2020;5:00;1;1;0
nede?a;16.8.2020;6:00;9;9;0
nede?a;16.8.2020;7:00;34;18;16
nede?a;16.8.2020;8:00;46;30;16
nede?a;16.8.2020;9:00;100;65;35
nede?a;16.8.2020;10:00;148;90;58
nede?a;16.8.2020;11:00;188;103;85
nede?a;16.8.2020;12:00;134;87;47
nede?a;16.8.2020;13:00;148;86;62
nede?a;16.8.2020;14:00;149;71;78
nede?a;16.8.2020;15:00;129;53;76
nede?a;16.8.2020;16:00;170;86;84
nede?a;16.8.2020;17:00;226;104;122
nede?a;16.8.2020;18:00;187;102;85
nede?a;16.8.2020;19:00;163;96;67
nede?a;16.8.2020;20:00;74;52;22
nede?a;16.8.2020;21:00;31;13;18
nede?a;16.8.2020;22:00;13;6;7
nede?a;16.8.2020;23:00;6;6;0
pondelok;17.8.2020;0:00;0;0;0
pondelok;17.8.2020;1:00;1;1;0
pondelok;17.8.2020;2:00;1;0;1
pondelok;17.8.2020;3:00;0;0;0
pondelok;17.8.2020;4:00;1;1;0
pondelok;17.8.2020;5:00;9;5;4
pondelok;17.8.2020;6:00;31;17;14
pondelok;17.8.2020;7:00;40;19;21
pondelok;17.8.2020;8:00;80;39;41
pondelok;17.8.2020;9:00;51;31;20
pondelok;17.8.2020;10:00;46;25;21
pondelok;17.8.2020;11:00;37;24;13
pondelok;17.8.2020;12:00;50;17;33
pondelok;17.8.2020;13:00;29;12;17
pondelok;17.8.2020;14:00;22;11;11
pondelok;17.8.2020;15:00;30;19;11
pondelok;17.8.2020;16:00;50;24;26
pondelok;17.8.2020;17:00;44;19;25
pondelok;17.8.2020;18:00;49;26;23
pondelok;17.8.2020;19:00;55;28;27
pondelok;17.8.2020;20:00;23;14;9
pondelok;17.8.2020;21:00;6;2;4
pondelok;17.8.2020;22:00;5;4;1
pondelok;17.8.2020;23:00;5;3;2
utorok;18.8.2020;0:00;1;1;0
utorok;18.8.2020;1:00;0;0;0
utorok;18.8.2020;2:00;1;1;0
utorok;18.8.2020;3:00;1;1;0
utorok;18.8.2020;4:00;0;0;0
utorok;18.8.2020;5:00;6;2;4
utorok;18.8.2020;6:00;21;14;7
utorok;18.8.2020;7:00;38;16;22
utorok;18.8.2020;8:00;54;22;32
utorok;18.8.2020;9:00;36;19;17
utorok;18.8.2020;10:00;27;10;17
utorok;18.8.2020;11:00;27;17;10
utorok;18.8.2020;12:00;30;12;18
utorok;18.8.2020;13:00;30;12;18
utorok;18.8.2020;14:00;50;31;19
utorok;18.8.2020;15:00;81;45;36
utorok;18.8.2020;16:00;170;98;72
utorok;18.8.2020;17:00;83;52;31
utorok;18.8.2020;18:00;56;27;29
utorok;18.8.2020;19:00;28;13;15
utorok;18.8.2020;20:00;10;7;3
utorok;18.8.2020;21:00;9;5;4
utorok;18.8.2020;22:00;8;5;3
utorok;18.8.2020;23:00;2;0;2
streda;19.8.2020;0:00;1;1;0
streda;19.8.2020;1:00;1;1;0
streda;19.8.2020;2:00;2;0;2
streda;19.8.2020;3:00;2;1;1
streda;19.8.2020;4:00;2;1;1
streda;19.8.2020;5:00;14;9;5
streda;19.8.2020;6:00;42;23;19
streda;19.8.2020;7:00;59;28;31
streda;19.8.2020;8:00;86;60;26
streda;19.8.2020;9:00;81;23;58
streda;19.8.2020;10:00;79;30;49
streda;19.8.2020;11:00;62;35;27
streda;19.8.2020;12:00;98;64;34
streda;19.8.2020;13:00;94;49;45
streda;19.8.2020;14:00;74;40;34
streda;19.8.2020;15:00;101;57;44
streda;19.8.2020;16:00;148;69;79
streda;19.8.2020;17:00;217;140;77
streda;19.8.2020;18:00;144;70;74
streda;19.8.2020;19:00;145;64;81
streda;19.8.2020;20:00;91;44;47
streda;19.8.2020;21:00;21;14;7
streda;19.8.2020;22:00;14;9;5
streda;19.8.2020;23:00;13;9;4
štvrtok;20.8.2020;0:00;2;1;1
štvrtok;20.8.2020;1:00;2;0;2
štvrtok;20.8.2020;2:00;1;1;0
štvrtok;20.8.2020;3:00;0;0;0
štvrtok;20.8.2020;4:00;4;3;1
štvrtok;20.8.2020;5:00;21;16;5
štvrtok;20.8.2020;6:00;46;28;18
štvrtok;20.8.2020;7:00;85;39;46
štvrtok;20.8.2020;8:00;105;48;57
štvrtok;20.8.2020;9:00;103;53;50
štvrtok;20.8.2020;10:00;122;66;56
štvrtok;20.8.2020;11:00;137;60;77
štvrtok;20.8.2020;12:00;108;65;43
štvrtok;20.8.2020;13:00;111;49;62
štvrtok;20.8.2020;14:00;146;80;66
štvrtok;20.8.2020;15:00;198;95;103
štvrtok;20.8.2020;16:00;260;147;113
štvrtok;20.8.2020;17:00;407;235;172
štvrtok;20.8.2020;18:00;344;198;146
štvrtok;20.8.2020;19:00;346;173;173
štvrtok;20.8.2020;20:00;167;85;82
štvrtok;20.8.2020;21:00;41;23;18
štvrtok;20.8.2020;22:00;25;16;9
štvrtok;20.8.2020;23:00;5;2;3
piatok;21.8.2020;0:00;4;3;1
piatok;21.8.2020;1:00;3;1;2
piatok;21.8.2020;2:00;3;1;2
piatok;21.8.2020;3:00;3;3;0
piatok;21.8.2020;4:00;3;2;1
piatok;21.8.2020;5:00;13;9;4
piatok;21.8.2020;6:00;39;26;13
piatok;21.8.2020;7:00;65;28;37
piatok;21.8.2020;8:00;94;56;38
piatok;21.8.2020;9:00;99;49;50
piatok;21.8.2020;10:00;90;53;37
piatok;21.8.2020;11:00;85;46;39
piatok;21.8.2020;12:00;97;43;54
piatok;21.8.2020;13:00;101;46;55
piatok;21.8.2020;14:00;121;65;56
piatok;21.8.2020;15:00;161;74;87
piatok;21.8.2020;16:00;192;98;94
piatok;21.8.2020;17:00;228;131;97
piatok;21.8.2020;18:00;200;110;90
piatok;21.8.2020;19:00;199;99;100
piatok;21.8.2020;20:00;113;69;44
piatok;21.8.2020;21:00;24;12;12
piatok;21.8.2020;22:00;19;15;4
piatok;21.8.2020;23:00;7;3;4
sobota;22.8.2020;0:00;6;5;1
sobota;22.8.2020;1:00;6;5;1
sobota;22.8.2020;2:00;0;0;0
sobota;22.8.2020;3:00;2;2;0
sobota;22.8.2020;4:00;2;1;1
sobota;22.8.2020;5:00;5;3;2
sobota;22.8.2020;6:00;10;8;2
sobota;22.8.2020;7:00;61;44;17
sobota;22.8.2020;8:00;103;74;29
sobota;22.8.2020;9:00;179;112;67
sobota;22.8.2020;10:00;240;145;95
sobota;22.8.2020;11:00;244;128;116
sobota;22.8.2020;12:00;192;87;105
sobota;22.8.2020;13:00;190;106;84
sobota;22.8.2020;14:00;201;100;101
sobota;22.8.2020;15:00;175;86;89
sobota;22.8.2020;16:00;192;99;93
sobota;22.8.2020;17:00;264;128;136
sobota;22.8.2020;18:00;154;82;72
sobota;22.8.2020;19:00;94;48;46
sobota;22.8.2020;20:00;14;8;6
sobota;22.8.2020;21:00;9;3;6
sobota;22.8.2020;22:00;4;3;1
sobota;22.8.2020;23:00;1;0;1
nede?a;23.8.2020;0:00;4;2;2
nede?a;23.8.2020;1:00;0;0;0
nede?a;23.8.2020;2:00;0;0;0
nede?a;23.8.2020;3:00;0;0;0
nede?a;23.8.2020;4:00;1;0;1
nede?a;23.8.2020;5:00;1;1;0
nede?a;23.8.2020;6:00;9;9;0
nede?a;23.8.2020;7:00;35;21;14
nede?a;23.8.2020;8:00;45;31;14
nede?a;23.8.2020;9:00;118;65;53
nede?a;23.8.2020;10:00;151;91;60
nede?a;23.8.2020;11:00;227;92;135
nede?a;23.8.2020;12:00;206;122;84
nede?a;23.8.2020;13:00;189;110;79
nede?a;23.8.2020;14:00;250;129;121
nede?a;23.8.2020;15:00;306;176;130
nede?a;23.8.2020;16:00;321;181;140
nede?a;23.8.2020;17:00;307;146;161
nede?a;23.8.2020;18:00;276;142;134
nede?a;23.8.2020;19:00;161;93;68
nede?a;23.8.2020;20:00;77;40;37
nede?a;23.8.2020;21:00;23;15;8
nede?a;23.8.2020;22:00;5;4;1
nede?a;23.8.2020;23:00;2;2;0
pondelok;24.8.2020;0:00;1;1;0
pondelok;24.8.2020;1:00;0;0;0
pondelok;24.8.2020;2:00;1;0;1
pondelok;24.8.2020;3:00;1;0;1
pondelok;24.8.2020;4:00;1;0;1
pondelok;24.8.2020;5:00;9;6;3
pondelok;24.8.2020;6:00;39;19;20
pondelok;24.8.2020;7:00;83;43;40
pondelok;24.8.2020;8:00;84;43;41
pondelok;24.8.2020;9:00;79;47;32
pondelok;24.8.2020;10:00;77;42;35
pondelok;24.8.2020;11:00;52;35;17
pondelok;24.8.2020;12:00;72;36;36
pondelok;24.8.2020;13:00;69;28;41
pondelok;24.8.2020;14:00;80;40;40
pondelok;24.8.2020;15:00;136;72;64
pondelok;24.8.2020;16:00;202;106;96
pondelok;24.8.2020;17:00;217;97;120
pondelok;24.8.2020;18:00;236;139;97
pondelok;24.8.2020;19:00;166;96;70
pondelok;24.8.2020;20:00;74;41;33
pondelok;24.8.2020;21:00;12;8;4
pondelok;24.8.2020;22:00;17;8;9
pondelok;24.8.2020;23:00;8;5;3
utorok;25.8.2020;0:00;2;2;0
utorok;25.8.2020;1:00;0;0;0
utorok;25.8.2020;2:00;0;0;0
utorok;25.8.2020;3:00;0;0;0
utorok;25.8.2020;4:00;1;1;0
utorok;25.8.2020;5:00;14;8;6
utorok;25.8.2020;6:00;50;30;20
utorok;25.8.2020;7:00;97;48;49
utorok;25.8.2020;8:00;113;67;46
utorok;25.8.2020;9:00;114;46;68
utorok;25.8.2020;10:00;72;38;34
utorok;25.8.2020;11:00;98;59;39
utorok;25.8.2020;12:00;102;56;46
utorok;25.8.2020;13:00;111;59;52
utorok;25.8.2020;14:00;106;54;52
utorok;25.8.2020;15:00;182;100;82
utorok;25.8.2020;16:00;266;142;124
utorok;25.8.2020;17:00;366;229;137
utorok;25.8.2020;18:00;322;173;149
utorok;25.8.2020;19:00;271;144;127
utorok;25.8.2020;20:00;129;69;60
utorok;25.8.2020;21:00;19;14;5
utorok;25.8.2020;22:00;22;11;11
utorok;25.8.2020;23:00;9;7;2
streda;26.8.2020;0:00;4;2;2
streda;26.8.2020;1:00;1;1;0
streda;26.8.2020;2:00;0;0;0
streda;26.8.2020;3:00;0;0;0
streda;26.8.2020;4:00;0;0;0
streda;26.8.2020;5:00;18;8;10
streda;26.8.2020;6:00;48;25;23
streda;26.8.2020;7:00;82;39;43
streda;26.8.2020;8:00;91;45;46
streda;26.8.2020;9:00;81;33;48
streda;26.8.2020;10:00;69;43;26
streda;26.8.2020;11:00;82;43;39
streda;26.8.2020;12:00;92;43;49
streda;26.8.2020;13:00;83;46;37
streda;26.8.2020;14:00;102;57;45
streda;26.8.2020;15:00;118;63;55
streda;26.8.2020;16:00;242;138;104
streda;26.8.2020;17:00;330;191;139
streda;26.8.2020;18:00;289;175;114
streda;26.8.2020;19:00;254;139;115
streda;26.8.2020;20:00;150;74;76
streda;26.8.2020;21:00;47;25;22
streda;26.8.2020;22:00;10;2;8
streda;26.8.2020;23:00;8;4;4
štvrtok;27.8.2020;0:00;3;1;2
štvrtok;27.8.2020;1:00;3;1;2
štvrtok;27.8.2020;2:00;1;0;1
štvrtok;27.8.2020;3:00;0;0;0
štvrtok;27.8.2020;4:00;1;1;0
štvrtok;27.8.2020;5:00;12;7;5
štvrtok;27.8.2020;6:00;40;27;13
štvrtok;27.8.2020;7:00;75;43;32
štvrtok;27.8.2020;8:00;92;42;50
štvrtok;27.8.2020;9:00;63;39;24
štvrtok;27.8.2020;10:00;61;39;22
štvrtok;27.8.2020;11:00;67;29;38
štvrtok;27.8.2020;12:00;59;30;29
štvrtok;27.8.2020;13:00;79;53;26
štvrtok;27.8.2020;14:00;90;41;49
štvrtok;27.8.2020;15:00;134;75;59
štvrtok;27.8.2020;16:00;220;120;100
štvrtok;27.8.2020;17:00;318;190;128
štvrtok;27.8.2020;18:00;274;145;129
štvrtok;27.8.2020;19:00;233;112;121
štvrtok;27.8.2020;20:00;76;46;30
štvrtok;27.8.2020;21:00;23;13;10
štvrtok;27.8.2020;22:00;61;10;51
štvrtok;27.8.2020;23:00;5;4;1
piatok;28.8.2020;0:00;2;0;2
piatok;28.8.2020;1:00;1;0;1
piatok;28.8.2020;2:00;1;1;0
piatok;28.8.2020;3:00;0;0;0
piatok;28.8.2020;4:00;1;0;1
piatok;28.8.2020;5:00;7;4;3
piatok;28.8.2020;6:00;41;27;14
piatok;28.8.2020;7:00;72;38;34
piatok;28.8.2020;8:00;88;48;40
piatok;28.8.2020;9:00;63;35;28
piatok;28.8.2020;10:00;92;44;48
piatok;28.8.2020;11:00;89;53;36
piatok;28.8.2020;12:00;73;30;43
piatok;28.8.2020;13:00;107;53;54
piatok;28.8.2020;14:00;100;62;38
piatok;28.8.2020;15:00;132;80;52
piatok;28.8.2020;16:00;215;103;112
piatok;28.8.2020;17:00;228;114;114
piatok;28.8.2020;18:00;191;93;98
piatok;28.8.2020;19:00;145;76;69
piatok;28.8.2020;20:00;52;31;21
piatok;28.8.2020;21:00;25;16;9
piatok;28.8.2020;22:00;16;7;9
piatok;28.8.2020;23:00;12;11;1
sobota;29.8.2020;0:00;7;1;6
sobota;29.8.2020;1:00;3;1;2
sobota;29.8.2020;2:00;6;6;0
sobota;29.8.2020;3:00;1;0;1
sobota;29.8.2020;4:00;0;0;0
sobota;29.8.2020;5:00;2;2;0
sobota;29.8.2020;6:00;8;7;1
sobota;29.8.2020;7:00;41;25;16
sobota;29.8.2020;8:00;86;60;26
sobota;29.8.2020;9:00;154;94;60
sobota;29.8.2020;10:00;274;147;127
sobota;29.8.2020;11:00;271;154;117
sobota;29.8.2020;12:00;201;101;100
sobota;29.8.2020;13:00;264;157;107
sobota;29.8.2020;14:00;256;137;119
sobota;29.8.2020;15:00;232;113;119
sobota;29.8.2020;16:00;288;157;131
sobota;29.8.2020;17:00;336;159;177
sobota;29.8.2020;18:00;225;143;82
sobota;29.8.2020;19:00;96;52;44
sobota;29.8.2020;20:00;35;14;21
sobota;29.8.2020;21:00;4;1;3
sobota;29.8.2020;22:00;11;5;6
sobota;29.8.2020;23:00;3;0;3
nede?a;30.8.2020;0:00;3;3;0
nede?a;30.8.2020;1:00;2;0;2
nede?a;30.8.2020;2:00;0;0;0
nede?a;30.8.2020;3:00;1;1;0
nede?a;30.8.2020;4:00;1;0;1
nede?a;30.8.2020;5:00;1;0;1
nede?a;30.8.2020;6:00;15;11;4
nede?a;30.8.2020;7:00;25;21;4
nede?a;30.8.2020;8:00;75;50;25
nede?a;30.8.2020;9:00;146;87;59
nede?a;30.8.2020;10:00;253;142;111
nede?a;30.8.2020;11:00;247;130;117
nede?a;30.8.2020;12:00;175;104;71
nede?a;30.8.2020;13:00;187;95;92
nede?a;30.8.2020;14:00;231;104;127
nede?a;30.8.2020;15:00;243;112;131
nede?a;30.8.2020;16:00;185;115;70
nede?a;30.8.2020;17:00;170;108;62
nede?a;30.8.2020;18:00;82;31;51
nede?a;30.8.2020;19:00;42;27;15
nede?a;30.8.2020;20:00;17;5;12
nede?a;30.8.2020;21:00;12;5;7
nede?a;30.8.2020;22:00;12;7;5
nede?a;30.8.2020;23:00;1;0;1
pondelok;31.8.2020;0:00;0;0;0
pondelok;31.8.2020;1:00;1;0;1
pondelok;31.8.2020;2:00;0;0;0
pondelok;31.8.2020;3:00;0;0;0
pondelok;31.8.2020;4:00;0;0;0
pondelok;31.8.2020;5:00;6;4;2
pondelok;31.8.2020;6:00;10;7;3
pondelok;31.8.2020;7:00;49;30;19
pondelok;31.8.2020;8:00;44;24;20
pondelok;31.8.2020;9:00;53;37;16
pondelok;31.8.2020;10:00;46;29;17
pondelok;31.8.2020;11:00;53;31;22
pondelok;31.8.2020;12:00;60;38;22
pondelok;31.8.2020;13:00;71;44;27
pondelok;31.8.2020;14:00;71;37;34
pondelok;31.8.2020;15:00;89;50;39
pondelok;31.8.2020;16:00;90;40;50
pondelok;31.8.2020;17:00;152;69;83
pondelok;31.8.2020;18:00;104;57;47
pondelok;31.8.2020;19:00;65;33;32
pondelok;31.8.2020;20:00;18;10;8
pondelok;31.8.2020;21:00;6;4;2
pondelok;31.8.2020;22:00;0;0;0
pondelok;31.8.2020;23:00;2;0;2
utorok;1.9.2020;0:00;4;1;3
utorok;1.9.2020;1:00;1;0;1
utorok;1.9.2020;2:00;0;0;0
utorok;1.9.2020;3:00;0;0;0
utorok;1.9.2020;4:00;0;0;0
utorok;1.9.2020;5:00;1;1;0
utorok;1.9.2020;6:00;1;0;1
utorok;1.9.2020;7:00;1;0;1
utorok;1.9.2020;8:00;1;1;0
utorok;1.9.2020;9:00;1;0;1
utorok;1.9.2020;10:00;0;0;0
utorok;1.9.2020;11:00;8;4;4
utorok;1.9.2020;12:00;10;7;3
utorok;1.9.2020;13:00;7;4;3
utorok;1.9.2020;14:00;1;1;0
utorok;1.9.2020;15:00;3;2;1
utorok;1.9.2020;16:00;4;3;1
utorok;1.9.2020;17:00;12;3;9
utorok;1.9.2020;18:00;25;14;11
utorok;1.9.2020;19:00;11;4;7
utorok;1.9.2020;20:00;12;9;3
utorok;1.9.2020;21:00;1;1;0
utorok;1.9.2020;22:00;0;0;0
utorok;1.9.2020;23:00;2;2;0
streda;2.9.2020;0:00;0;0;0
streda;2.9.2020;1:00;0;0;0
streda;2.9.2020;2:00;0;0;0
streda;2.9.2020;3:00;0;0;0
streda;2.9.2020;4:00;1;0;1
streda;2.9.2020;5:00;7;4;3
streda;2.9.2020;6:00;25;16;9
streda;2.9.2020;7:00;51;23;28
streda;2.9.2020;8:00;64;33;31
streda;2.9.2020;9:00;60;32;28
streda;2.9.2020;10:00;58;26;32
streda;2.9.2020;11:00;63;39;24
streda;2.9.2020;12:00;90;57;33
streda;2.9.2020;13:00;67;39;28
streda;2.9.2020;14:00;116;56;60
streda;2.9.2020;15:00;145;94;51
streda;2.9.2020;16:00;253;143;110
streda;2.9.2020;17:00;309;193;116
streda;2.9.2020;18:00;236;120;116
streda;2.9.2020;19:00;186;90;96
streda;2.9.2020;20:00;40;16;24
streda;2.9.2020;21:00;26;15;11
streda;2.9.2020;22:00;9;5;4
streda;2.9.2020;23:00;6;3;3
štvrtok;3.9.2020;0:00;4;2;2
štvrtok;3.9.2020;1:00;0;0;0
štvrtok;3.9.2020;2:00;1;0;1
štvrtok;3.9.2020;3:00;0;0;0
štvrtok;3.9.2020;4:00;0;0;0
štvrtok;3.9.2020;5:00;4;2;2
štvrtok;3.9.2020;6:00;18;13;5
štvrtok;3.9.2020;7:00;52;25;27
štvrtok;3.9.2020;8:00;87;49;38
štvrtok;3.9.2020;9:00;62;39;23
štvrtok;3.9.2020;10:00;38;29;9
štvrtok;3.9.2020;11:00;64;27;37
štvrtok;3.9.2020;12:00;84;49;35
štvrtok;3.9.2020;13:00;88;51;37
štvrtok;3.9.2020;14:00;106;51;55
štvrtok;3.9.2020;15:00;132;76;56
štvrtok;3.9.2020;16:00;235;128;107
štvrtok;3.9.2020;17:00;343;203;140
štvrtok;3.9.2020;18:00;282;167;115
štvrtok;3.9.2020;19:00;244;126;118
štvrtok;3.9.2020;20:00;54;20;34
štvrtok;3.9.2020;21:00;17;8;9
štvrtok;3.9.2020;22:00;11;6;5
štvrtok;3.9.2020;23:00;5;5;0
piatok;4.9.2020;0:00;1;0;1
piatok;4.9.2020;1:00;0;0;0
piatok;4.9.2020;2:00;0;0;0
piatok;4.9.2020;3:00;0;0;0
piatok;4.9.2020;4:00;0;0;0
piatok;4.9.2020;5:00;10;6;4
piatok;4.9.2020;6:00;40;29;11
piatok;4.9.2020;7:00;92;39;53
piatok;4.9.2020;8:00;103;67;36
piatok;4.9.2020;9:00;53;32;21
piatok;4.9.2020;10:00;66;36;30
piatok;4.9.2020;11:00;60;31;29
piatok;4.9.2020;12:00;71;33;38
piatok;4.9.2020;13:00;93;42;51
piatok;4.9.2020;14:00;99;56;43
piatok;4.9.2020;15:00;166;95;71
piatok;4.9.2020;16:00;237;125;112
piatok;4.9.2020;17:00;296;166;130
piatok;4.9.2020;18:00;291;150;141
piatok;4.9.2020;19:00;206;108;98
piatok;4.9.2020;20:00;68;38;30
piatok;4.9.2020;21:00;15;6;9
piatok;4.9.2020;22:00;19;14;5
piatok;4.9.2020;23:00;15;11;4
sobota;5.9.2020;0:00;10;5;5
sobota;5.9.2020;1:00;0;0;0
sobota;5.9.2020;2:00;3;3;0
sobota;5.9.2020;3:00;1;0;1
sobota;5.9.2020;4:00;2;0;2
sobota;5.9.2020;5:00;3;2;1
sobota;5.9.2020;6:00;23;20;3
sobota;5.9.2020;7:00;39;26;13
sobota;5.9.2020;8:00;89;59;30
sobota;5.9.2020;9:00;182;129;53
sobota;5.9.2020;10:00;307;206;101
sobota;5.9.2020;11:00;326;197;129
sobota;5.9.2020;12:00;331;177;154
sobota;5.9.2020;13:00;302;177;125
sobota;5.9.2020;14:00;349;195;154
sobota;5.9.2020;15:00;378;207;171
sobota;5.9.2020;16:00;397;191;206
sobota;5.9.2020;17:00;454;219;235
sobota;5.9.2020;18:00;357;173;184
sobota;5.9.2020;19:00;259;124;135
sobota;5.9.2020;20:00;89;37;52
sobota;5.9.2020;21:00;22;12;10
sobota;5.9.2020;22:00;8;2;6
sobota;5.9.2020;23:00;7;4;3
nede?a;6.9.2020;0:00;6;2;4
nede?a;6.9.2020;1:00;2;1;1
nede?a;6.9.2020;2:00;0;0;0
nede?a;6.9.2020;3:00;0;0;0
nede?a;6.9.2020;4:00;0;0;0
nede?a;6.9.2020;5:00;1;1;0
nede?a;6.9.2020;6:00;4;3;1
nede?a;6.9.2020;7:00;11;6;5
nede?a;6.9.2020;8:00;30;17;13
nede?a;6.9.2020;9:00;56;40;16
nede?a;6.9.2020;10:00;70;47;23
nede?a;6.9.2020;11:00;78;48;30
nede?a;6.9.2020;12:00;85;57;28
nede?a;6.9.2020;13:00;106;60;46
nede?a;6.9.2020;14:00;152;75;77
nede?a;6.9.2020;15:00;148;78;70
nede?a;6.9.2020;16:00;158;95;63
nede?a;6.9.2020;17:00;206;100;106
nede?a;6.9.2020;18:00;175;100;75
nede?a;6.9.2020;19:00;64;33;31
nede?a;6.9.2020;20:00;31;20;11
nede?a;6.9.2020;21:00;9;3;6
nede?a;6.9.2020;22:00;3;0;3
nede?a;6.9.2020;23:00;2;1;1
pondelok;7.9.2020;0:00;1;1;0
pondelok;7.9.2020;1:00;1;1;0
pondelok;7.9.2020;2:00;0;0;0
pondelok;7.9.2020;3:00;0;0;0
pondelok;7.9.2020;4:00;1;1;0
pondelok;7.9.2020;5:00;5;2;3
pondelok;7.9.2020;6:00;12;6;6
pondelok;7.9.2020;7:00;19;9;10
pondelok;7.9.2020;8:00;38;15;23
pondelok;7.9.2020;9:00;15;10;5
pondelok;7.9.2020;10:00;20;13;7
pondelok;7.9.2020;11:00;36;23;13
pondelok;7.9.2020;12:00;43;22;21
pondelok;7.9.2020;13:00;36;20;16
pondelok;7.9.2020;14:00;40;23;17
pondelok;7.9.2020;15:00;98;59;39
pondelok;7.9.2020;16:00;138;75;63
pondelok;7.9.2020;17:00;173;100;73
pondelok;7.9.2020;18:00;163;82;81
pondelok;7.9.2020;19:00;84;47;37
pondelok;7.9.2020;20:00;16;5;11
pondelok;7.9.2020;21:00;11;5;6
pondelok;7.9.2020;22:00;2;2;0
pondelok;7.9.2020;23:00;3;3;0
utorok;8.9.2020;0:00;3;0;3
utorok;8.9.2020;1:00;1;1;0
utorok;8.9.2020;2:00;0;0;0
utorok;8.9.2020;3:00;0;0;0
utorok;8.9.2020;4:00;3;2;1
utorok;8.9.2020;5:00;8;3;5
utorok;8.9.2020;6:00;61;41;20
utorok;8.9.2020;7:00;101;43;58
utorok;8.9.2020;8:00;131;73;58
utorok;8.9.2020;9:00;65;34;31
utorok;8.9.2020;10:00;82;53;29
utorok;8.9.2020;11:00;66;35;31
utorok;8.9.2020;12:00;85;41;44
utorok;8.9.2020;13:00;88;47;41
utorok;8.9.2020;14:00;124;70;54
utorok;8.9.2020;15:00;213;124;89
utorok;8.9.2020;16:00;319;185;134
utorok;8.9.2020;17:00;428;278;150
utorok;8.9.2020;18:00;361;196;165
utorok;8.9.2020;19:00;259;140;119
utorok;8.9.2020;20:00;69;28;41
utorok;8.9.2020;21:00;17;10;7
utorok;8.9.2020;22:00;9;9;0
utorok;8.9.2020;23:00;3;1;2
streda;9.9.2020;0:00;1;0;1
streda;9.9.2020;1:00;0;0;0
streda;9.9.2020;2:00;1;1;0
streda;9.9.2020;3:00;0;0;0
streda;9.9.2020;4:00;3;1;2
streda;9.9.2020;5:00;11;5;6
streda;9.9.2020;6:00;48;23;25
streda;9.9.2020;7:00;78;38;40
streda;9.9.2020;8:00;109;49;60
streda;9.9.2020;9:00;77;43;34
streda;9.9.2020;10:00;61;42;19
streda;9.9.2020;11:00;90;51;39
streda;9.9.2020;12:00;79;37;42
streda;9.9.2020;13:00;102;51;51
streda;9.9.2020;14:00;123;65;58
streda;9.9.2020;15:00;186;102;84
streda;9.9.2020;16:00;298;170;128
streda;9.9.2020;17:00;374;242;132
streda;9.9.2020;18:00;366;185;181
streda;9.9.2020;19:00;237;123;114
streda;9.9.2020;20:00;76;45;31
streda;9.9.2020;21:00;28;10;18
streda;9.9.2020;22:00;12;9;3
streda;9.9.2020;23:00;6;1;5
štvrtok;10.9.2020;0:00;5;4;1
štvrtok;10.9.2020;1:00;0;0;0
štvrtok;10.9.2020;2:00;1;0;1
štvrtok;10.9.2020;3:00;0;0;0
štvrtok;10.9.2020;4:00;2;2;0
štvrtok;10.9.2020;5:00;8;5;3
štvrtok;10.9.2020;6:00;49;35;14
štvrtok;10.9.2020;7:00;88;47;41
štvrtok;10.9.2020;8:00;120;65;55
štvrtok;10.9.2020;9:00;69;43;26
štvrtok;10.9.2020;10:00;87;54;33
štvrtok;10.9.2020;11:00;69;28;41
štvrtok;10.9.2020;12:00;89;40;49
štvrtok;10.9.2020;13:00;93;46;47
štvrtok;10.9.2020;14:00;105;54;51
štvrtok;10.9.2020;15:00;157;85;72
štvrtok;10.9.2020;16:00;264;148;116
štvrtok;10.9.2020;17:00;374;219;155
štvrtok;10.9.2020;18:00;269;151;118
štvrtok;10.9.2020;19:00;195;88;107
štvrtok;10.9.2020;20:00;57;30;27
štvrtok;10.9.2020;21:00;31;10;21
štvrtok;10.9.2020;22:00;19;11;8
štvrtok;10.9.2020;23:00;5;3;2
piatok;11.9.2020;0:00;6;3;3
piatok;11.9.2020;1:00;1;0;1
piatok;11.9.2020;2:00;0;0;0
piatok;11.9.2020;3:00;1;1;0
piatok;11.9.2020;4:00;1;0;1
piatok;11.9.2020;5:00;8;1;7
piatok;11.9.2020;6:00;36;25;11
piatok;11.9.2020;7:00;83;46;37
piatok;11.9.2020;8:00;108;60;48
piatok;11.9.2020;9:00;58;33;25
piatok;11.9.2020;10:00;64;35;29
piatok;11.9.2020;11:00;78;46;32
piatok;11.9.2020;12:00;71;38;33
piatok;11.9.2020;13:00;80;39;41
piatok;11.9.2020;14:00;107;56;51
piatok;11.9.2020;15:00;169;92;77
piatok;11.9.2020;16:00;221;140;81
piatok;11.9.2020;17:00;256;115;141
piatok;11.9.2020;18:00;190;113;77
piatok;11.9.2020;19:00;184;92;92
piatok;11.9.2020;20:00;49;31;18
piatok;11.9.2020;21:00;23;15;8
piatok;11.9.2020;22:00;22;14;8
piatok;11.9.2020;23:00;11;9;2
sobota;12.9.2020;0:00;5;3;2
sobota;12.9.2020;1:00;9;3;6
sobota;12.9.2020;2:00;1;0;1
sobota;12.9.2020;3:00;2;1;1
sobota;12.9.2020;4:00;2;1;1
sobota;12.9.2020;5:00;2;2;0
sobota;12.9.2020;6:00;21;19;2
sobota;12.9.2020;7:00;28;19;9
sobota;12.9.2020;8:00;54;38;16
sobota;12.9.2020;9:00;165;109;56
sobota;12.9.2020;10:00;206;145;61
sobota;12.9.2020;11:00;239;139;100
sobota;12.9.2020;12:00;194;100;94
sobota;12.9.2020;13:00;248;124;124
sobota;12.9.2020;14:00;296;144;152
sobota;12.9.2020;15:00;263;138;125
sobota;12.9.2020;16:00;349;176;173
sobota;12.9.2020;17:00;266;129;137
sobota;12.9.2020;18:00;325;168;157
sobota;12.9.2020;19:00;138;60;78
sobota;12.9.2020;20:00;46;24;22
sobota;12.9.2020;21:00;11;3;8
sobota;12.9.2020;22:00;9;5;4
sobota;12.9.2020;23:00;7;4;3
nede?a;13.9.2020;0:00;2;1;1
nede?a;13.9.2020;1:00;5;2;3
nede?a;13.9.2020;2:00;1;1;0
nede?a;13.9.2020;3:00;1;0;1
nede?a;13.9.2020;4:00;1;0;1
nede?a;13.9.2020;5:00;1;1;0
nede?a;13.9.2020;6:00;11;7;4
nede?a;13.9.2020;7:00;11;5;6
nede?a;13.9.2020;8:00;60;43;17
nede?a;13.9.2020;9:00;153;95;58
nede?a;13.9.2020;10:00;266;177;89
nede?a;13.9.2020;11:00;238;126;112
nede?a;13.9.2020;12:00;232;125;107
nede?a;13.9.2020;13:00;251;123;128
nede?a;13.9.2020;14:00;300;151;149
nede?a;13.9.2020;15:00;331;175;156
nede?a;13.9.2020;16:00;357;183;174
nede?a;13.9.2020;17:00;400;178;222
nede?a;13.9.2020;18:00;278;149;129
nede?a;13.9.2020;19:00;136;81;55
nede?a;13.9.2020;20:00;38;22;16
nede?a;13.9.2020;21:00;12;5;7
nede?a;13.9.2020;22:00;9;5;4
nede?a;13.9.2020;23:00;5;2;3
pondelok;14.9.2020;0:00;1;0;1
pondelok;14.9.2020;1:00;1;1;0
pondelok;14.9.2020;2:00;0;0;0
pondelok;14.9.2020;3:00;1;0;1
pondelok;14.9.2020;4:00;3;2;1
pondelok;14.9.2020;5:00;5;2;3
pondelok;14.9.2020;6:00;20;11;9
pondelok;14.9.2020;7:00;62;26;36
pondelok;14.9.2020;8:00;102;34;68
pondelok;14.9.2020;9:00;79;50;29
pondelok;14.9.2020;10:00;95;66;29
pondelok;14.9.2020;11:00;129;63;66
pondelok;14.9.2020;12:00;93;52;41
pondelok;14.9.2020;13:00;93;52;41
pondelok;14.9.2020;14:00;146;73;73
pondelok;14.9.2020;15:00;180;103;77
pondelok;14.9.2020;16:00;215;120;95
pondelok;14.9.2020;17:00;248;135;113
pondelok;14.9.2020;18:00;287;156;131
pondelok;14.9.2020;19:00;144;72;72
pondelok;14.9.2020;20:00;35;26;9
pondelok;14.9.2020;21:00;24;19;5
pondelok;14.9.2020;22:00;12;6;6
pondelok;14.9.2020;23:00;10;5;5
utorok;15.9.2020;0:00;3;2;1
utorok;15.9.2020;1:00;0;0;0
utorok;15.9.2020;2:00;0;0;0
utorok;15.9.2020;3:00;1;1;0
utorok;15.9.2020;4:00;1;1;0
utorok;15.9.2020;5:00;5;3;2
utorok;15.9.2020;6:00;21;16;5
utorok;15.9.2020;7:00;51;31;20
utorok;15.9.2020;8:00;96;70;26
utorok;15.9.2020;9:00;245;174;71
utorok;15.9.2020;10:00;449;286;163
utorok;15.9.2020;11:00;425;234;191
utorok;15.9.2020;12:00;406;218;188
utorok;15.9.2020;13:00;321;170;151
utorok;15.9.2020;14:00;391;193;198
utorok;15.9.2020;15:00;405;222;183
utorok;15.9.2020;16:00;463;237;226
utorok;15.9.2020;17:00;441;225;216
utorok;15.9.2020;18:00;394;195;199
utorok;15.9.2020;19:00;196;95;101
utorok;15.9.2020;20:00;49;25;24
utorok;15.9.2020;21:00;14;9;5
utorok;15.9.2020;22:00;4;2;2
utorok;15.9.2020;23:00;7;3;4
streda;16.9.2020;0:00;3;1;2
streda;16.9.2020;1:00;1;1;0
streda;16.9.2020;2:00;2;1;1
streda;16.9.2020;3:00;1;1;0
streda;16.9.2020;4:00;2;1;1
streda;16.9.2020;5:00;9;6;3
streda;16.9.2020;6:00;44;26;18
streda;16.9.2020;7:00;77;38;39
streda;16.9.2020;8:00;94;49;45
streda;16.9.2020;9:00;66;37;29
streda;16.9.2020;10:00;61;39;22
streda;16.9.2020;11:00;69;38;31
streda;16.9.2020;12:00;59;28;31
streda;16.9.2020;13:00;60;30;30
streda;16.9.2020;14:00;77;45;32
streda;16.9.2020;15:00;154;89;65
streda;16.9.2020;16:00;220;122;98
streda;16.9.2020;17:00;272;167;105
streda;16.9.2020;18:00;286;144;142
streda;16.9.2020;19:00;162;82;80
streda;16.9.2020;20:00;37;24;13
streda;16.9.2020;21:00;29;19;10
streda;16.9.2020;22:00;6;4;2
streda;16.9.2020;23:00;3;2;1
štvrtok;17.9.2020;0:00;4;0;4
štvrtok;17.9.2020;1:00;0;0;0
štvrtok;17.9.2020;2:00;0;0;0
štvrtok;17.9.2020;3:00;0;0;0
štvrtok;17.9.2020;4:00;2;1;1
štvrtok;17.9.2020;5:00;11;10;1
štvrtok;17.9.2020;6:00;46;20;26
štvrtok;17.9.2020;7:00;80;46;34
štvrtok;17.9.2020;8:00;99;51;48
štvrtok;17.9.2020;9:00;70;33;37
štvrtok;17.9.2020;10:00;41;25;16
štvrtok;17.9.2020;11:00;34;17;17
štvrtok;17.9.2020;12:00;37;19;18
štvrtok;17.9.2020;13:00;50;27;23
štvrtok;17.9.2020;14:00;73;36;37
štvrtok;17.9.2020;15:00;120;72;48
štvrtok;17.9.2020;16:00;184;114;70
štvrtok;17.9.2020;17:00;219;112;107
štvrtok;17.9.2020;18:00;182;95;87
štvrtok;17.9.2020;19:00;122;52;70
štvrtok;17.9.2020;20:00;24;15;9
štvrtok;17.9.2020;21:00;17;7;10
štvrtok;17.9.2020;22:00;13;6;7
štvrtok;17.9.2020;23:00;3;1;2
piatok;18.9.2020;0:00;0;0;0
piatok;18.9.2020;1:00;4;2;2
piatok;18.9.2020;2:00;0;0;0
piatok;18.9.2020;3:00;2;2;0
piatok;18.9.2020;4:00;0;0;0
piatok;18.9.2020;5:00;5;2;3
piatok;18.9.2020;6:00;35;20;15
piatok;18.9.2020;7:00;55;29;26
piatok;18.9.2020;8:00;95;47;48
piatok;18.9.2020;9:00;44;23;21
piatok;18.9.2020;10:00;47;26;21
piatok;18.9.2020;11:00;37;20;17
piatok;18.9.2020;12:00;56;24;32
piatok;18.9.2020;13:00;51;23;28
piatok;18.9.2020;14:00;94;56;38
piatok;18.9.2020;15:00;156;91;65
piatok;18.9.2020;16:00;201;106;95
piatok;18.9.2020;17:00;234;132;102
piatok;18.9.2020;18:00;181;99;82
piatok;18.9.2020;19:00;100;49;51
piatok;18.9.2020;20:00;30;13;17
piatok;18.9.2020;21:00;15;9;6
piatok;18.9.2020;22:00;2;0;2
piatok;18.9.2020;23:00;9;3;6
sobota;19.9.2020;0:00;3;3;0
sobota;19.9.2020;1:00;5;2;3
sobota;19.9.2020;2:00;0;0;0
sobota;19.9.2020;3:00;1;0;1
sobota;19.9.2020;4:00;4;3;1
sobota;19.9.2020;5:00;2;2;0
sobota;19.9.2020;6:00;3;3;0
sobota;19.9.2020;7:00;23;15;8
sobota;19.9.2020;8:00;56;35;21
sobota;19.9.2020;9:00;87;54;33
sobota;19.9.2020;10:00;142;90;52
sobota;19.9.2020;11:00;193;122;71
sobota;19.9.2020;12:00;215;130;85
sobota;19.9.2020;13:00;189;89;100
sobota;19.9.2020;14:00;259;160;99
sobota;19.9.2020;15:00;301;167;134
sobota;19.9.2020;16:00;297;154;143
sobota;19.9.2020;17:00;290;131;159
sobota;19.9.2020;18:00;229;116;113
sobota;19.9.2020;19:00;83;32;51
sobota;19.9.2020;20:00;13;5;8
sobota;19.9.2020;21:00;6;3;3
sobota;19.9.2020;22:00;3;1;2
sobota;19.9.2020;23:00;4;1;3
nede?a;20.9.2020;0:00;4;2;2
nede?a;20.9.2020;1:00;5;3;2
nede?a;20.9.2020;2:00;0;0;0
nede?a;20.9.2020;3:00;1;1;0
nede?a;20.9.2020;4:00;1;0;1
nede?a;20.9.2020;5:00;1;1;0
nede?a;20.9.2020;6:00;5;4;1
nede?a;20.9.2020;7:00;20;14;6
nede?a;20.9.2020;8:00;47;37;10
nede?a;20.9.2020;9:00;105;65;40
nede?a;20.9.2020;10:00;186;122;64
nede?a;20.9.2020;11:00;202;125;77
nede?a;20.9.2020;12:00;233;146;87
nede?a;20.9.2020;13:00;269;144;125
nede?a;20.9.2020;14:00;306;164;142
nede?a;20.9.2020;15:00;318;165;153
nede?a;20.9.2020;16:00;414;219;195
nede?a;20.9.2020;17:00;338;165;173
nede?a;20.9.2020;18:00;247;125;122
nede?a;20.9.2020;19:00;76;37;39
nede?a;20.9.2020;20:00;21;11;10
nede?a;20.9.2020;21:00;11;5;6
nede?a;20.9.2020;22:00;6;6;0
nede?a;20.9.2020;23:00;3;0;3
pondelok;21.9.2020;0:00;3;1;2
pondelok;21.9.2020;1:00;0;0;0
pondelok;21.9.2020;2:00;0;0;0
pondelok;21.9.2020;3:00;1;1;0
pondelok;21.9.2020;4:00;2;1;1
pondelok;21.9.2020;5:00;7;4;3
pondelok;21.9.2020;6:00;33;20;13
pondelok;21.9.2020;7:00;74;42;32
pondelok;21.9.2020;8:00;95;50;45
pondelok;21.9.2020;9:00;51;34;17
pondelok;21.9.2020;10:00;53;28;25
pondelok;21.9.2020;11:00;64;40;24
pondelok;21.9.2020;12:00;46;22;24
pondelok;21.9.2020;13:00;62;24;38
pondelok;21.9.2020;14:00;76;36;40
pondelok;21.9.2020;15:00;132;78;54
pondelok;21.9.2020;16:00;239;146;93
pondelok;21.9.2020;17:00;281;165;116
pondelok;21.9.2020;18:00;209;113;96
pondelok;21.9.2020;19:00;117;60;57
pondelok;21.9.2020;20:00;42;19;23
pondelok;21.9.2020;21:00;18;13;5
pondelok;21.9.2020;22:00;6;2;4
pondelok;21.9.2020;23:00;2;1;1
utorok;22.9.2020;0:00;0;0;0
utorok;22.9.2020;1:00;1;1;0
utorok;22.9.2020;2:00;0;0;0
utorok;22.9.2020;3:00;0;0;0
utorok;22.9.2020;4:00;1;1;0
utorok;22.9.2020;5:00;14;9;5
utorok;22.9.2020;6:00;49;31;18
utorok;22.9.2020;7:00;85;43;42
utorok;22.9.2020;8:00;125;57;68
utorok;22.9.2020;9:00;60;38;22
utorok;22.9.2020;10:00;80;51;29
utorok;22.9.2020;11:00;105;62;43
utorok;22.9.2020;12:00;73;38;35
utorok;22.9.2020;13:00;85;48;37
utorok;22.9.2020;14:00;134;68;66
utorok;22.9.2020;15:00;186;107;79
utorok;22.9.2020;16:00;354;209;145
utorok;22.9.2020;17:00;441;269;172
utorok;22.9.2020;18:00;381;188;193
utorok;22.9.2020;19:00;153;63;90
utorok;22.9.2020;20:00;43;18;25
utorok;22.9.2020;21:00;18;11;7
utorok;22.9.2020;22:00;15;10;5
utorok;22.9.2020;23:00;7;2;5
streda;23.9.2020;0:00;0;0;0
streda;23.9.2020;1:00;2;0;2
streda;23.9.2020;2:00;2;1;1
streda;23.9.2020;3:00;0;0;0
streda;23.9.2020;4:00;1;1;0
streda;23.9.2020;5:00;6;4;2
streda;23.9.2020;6:00;36;19;17
streda;23.9.2020;7:00;69;32;37
streda;23.9.2020;8:00;79;34;45
streda;23.9.2020;9:00;64;35;29
streda;23.9.2020;10:00;83;53;30
streda;23.9.2020;11:00;78;50;28
streda;23.9.2020;12:00;73;40;33
streda;23.9.2020;13:00;73;40;33
streda;23.9.2020;14:00;84;37;47
streda;23.9.2020;15:00;129;82;47
streda;23.9.2020;16:00;150;87;63
streda;23.9.2020;17:00;216;126;90
streda;23.9.2020;18:00;144;80;64
streda;23.9.2020;19:00;73;35;38
streda;23.9.2020;20:00;18;10;8
streda;23.9.2020;21:00;12;5;7
streda;23.9.2020;22:00;7;1;6
streda;23.9.2020;23:00;5;3;2
štvrtok;24.9.2020;0:00;0;0;0
štvrtok;24.9.2020;1:00;0;0;0
štvrtok;24.9.2020;2:00;0;0;0
štvrtok;24.9.2020;3:00;0;0;0
štvrtok;24.9.2020;4:00;2;1;1
štvrtok;24.9.2020;5:00;7;2;5
štvrtok;24.9.2020;6:00;47;27;20
štvrtok;24.9.2020;7:00;76;33;43
štvrtok;24.9.2020;8:00;106;43;63
štvrtok;24.9.2020;9:00;63;46;17
štvrtok;24.9.2020;10:00;58;32;26
štvrtok;24.9.2020;11:00;67;42;25
štvrtok;24.9.2020;12:00;97;55;42
štvrtok;24.9.2020;13:00;92;45;47
štvrtok;24.9.2020;14:00;145;68;77
štvrtok;24.9.2020;15:00;206;132;74
štvrtok;24.9.2020;16:00;311;192;119
štvrtok;24.9.2020;17:00;352;212;140
štvrtok;24.9.2020;18:00;309;151;158
štvrtok;24.9.2020;19:00;135;62;73
štvrtok;24.9.2020;20:00;51;25;26
štvrtok;24.9.2020;21:00;26;10;16
štvrtok;24.9.2020;22:00;10;7;3
štvrtok;24.9.2020;23:00;7;4;3
piatok;25.9.2020;0:00;3;3;0
piatok;25.9.2020;1:00;2;2;0
piatok;25.9.2020;2:00;1;0;1
piatok;25.9.2020;3:00;0;0;0
piatok;25.9.2020;4:00;1;0;1
piatok;25.9.2020;5:00;6;3;3
piatok;25.9.2020;6:00;22;17;5
piatok;25.9.2020;7:00;38;21;17
piatok;25.9.2020;8:00;28;12;16
piatok;25.9.2020;9:00;2;0;2
piatok;25.9.2020;10:00;1;1;0
piatok;25.9.2020;11:00;1;0;1
piatok;25.9.2020;12:00;5;3;2
piatok;25.9.2020;13:00;3;1;2
piatok;25.9.2020;14:00;10;2;8
piatok;25.9.2020;15:00;17;8;9
piatok;25.9.2020;16:00;24;13;11
piatok;25.9.2020;17:00;27;13;14
piatok;25.9.2020;18:00;22;14;8
piatok;25.9.2020;19:00;34;12;22
piatok;25.9.2020;20:00;9;4;5
piatok;25.9.2020;21:00;2;1;1
piatok;25.9.2020;22:00;1;1;0
piatok;25.9.2020;23:00;1;0;1
sobota;26.9.2020;0:00;1;0;1
sobota;26.9.2020;1:00;0;0;0
sobota;26.9.2020;2:00;0;0;0
sobota;26.9.2020;3:00;0;0;0
sobota;26.9.2020;4:00;1;0;1
sobota;26.9.2020;5:00;0;0;0
sobota;26.9.2020;6:00;0;0;0
sobota;26.9.2020;7:00;3;3;0
sobota;26.9.2020;8:00;4;2;2
sobota;26.9.2020;9:00;7;3;4
sobota;26.9.2020;10:00;10;3;7
sobota;26.9.2020;11:00;14;5;9
sobota;26.9.2020;12:00;20;12;8
sobota;26.9.2020;13:00;37;24;13
sobota;26.9.2020;14:00;49;31;18
sobota;26.9.2020;15:00;63;39;24
sobota;26.9.2020;16:00;64;29;35
sobota;26.9.2020;17:00;50;21;29
sobota;26.9.2020;18:00;48;35;13
sobota;26.9.2020;19:00;17;8;9
sobota;26.9.2020;20:00;4;1;3
sobota;26.9.2020;21:00;1;1;0
sobota;26.9.2020;22:00;0;0;0
sobota;26.9.2020;23:00;0;0;0
nede?a;27.9.2020;0:00;0;0;0
nede?a;27.9.2020;1:00;0;0;0
nede?a;27.9.2020;2:00;0;0;0
nede?a;27.9.2020;3:00;1;0;1
nede?a;27.9.2020;4:00;0;0;0
nede?a;27.9.2020;5:00;0;0;0
nede?a;27.9.2020;6:00;4;3;1
nede?a;27.9.2020;7:00;5;4;1
nede?a;27.9.2020;8:00;24;12;12
nede?a;27.9.2020;9:00;61;41;20
nede?a;27.9.2020;10:00;143;96;47
nede?a;27.9.2020;11:00;148;100;48
nede?a;27.9.2020;12:00;149;98;51
nede?a;27.9.2020;13:00;193;107;86
nede?a;27.9.2020;14:00;323;186;137
nede?a;27.9.2020;15:00;350;178;172
nede?a;27.9.2020;16:00;323;170;153
nede?a;27.9.2020;17:00;272;136;136
nede?a;27.9.2020;18:00;130;59;71
nede?a;27.9.2020;19:00;33;13;20
nede?a;27.9.2020;20:00;15;5;10
nede?a;27.9.2020;21:00;6;4;2
nede?a;27.9.2020;22:00;2;1;1
nede?a;27.9.2020;23:00;0;0;0
