day;date;time;Spolu_prejazdy;Smer_MostSNP;Smer_Stary_most
utorok;1.1.2019;0:00;5;1;4
utorok;1.1.2019;1:00;1;0;1
utorok;1.1.2019;2:00;2;0;2
utorok;1.1.2019;3:00;0;0;0
utorok;1.1.2019;4:00;0;0;0
utorok;1.1.2019;5:00;0;0;0
utorok;1.1.2019;6:00;1;1;0
utorok;1.1.2019;7:00;1;1;0
utorok;1.1.2019;8:00;2;0;2
utorok;1.1.2019;9:00;1;0;1
utorok;1.1.2019;10:00;2;1;1
utorok;1.1.2019;11:00;3;1;2
utorok;1.1.2019;12:00;4;3;1
utorok;1.1.2019;13:00;5;2;3
utorok;1.1.2019;14:00;14;10;4
utorok;1.1.2019;15:00;14;5;9
utorok;1.1.2019;16:00;5;3;2
utorok;1.1.2019;17:00;3;1;2
utorok;1.1.2019;18:00;6;6;0
utorok;1.1.2019;19:00;2;0;2
utorok;1.1.2019;20:00;2;0;2
utorok;1.1.2019;21:00;1;1;0
utorok;1.1.2019;22:00;0;0;0
utorok;1.1.2019;23:00;1;0;1
streda;2.1.2019;0:00;2;0;2
streda;2.1.2019;1:00;0;0;0
streda;2.1.2019;2:00;0;0;0
streda;2.1.2019;3:00;0;0;0
streda;2.1.2019;4:00;0;0;0
streda;2.1.2019;5:00;1;0;1
streda;2.1.2019;6:00;5;2;3
streda;2.1.2019;7:00;3;2;1
streda;2.1.2019;8:00;4;1;3
streda;2.1.2019;9:00;5;2;3
streda;2.1.2019;10:00;7;5;2
streda;2.1.2019;11:00;2;0;2
streda;2.1.2019;12:00;5;2;3
streda;2.1.2019;13:00;7;3;4
streda;2.1.2019;14:00;5;3;2
streda;2.1.2019;15:00;7;2;5
streda;2.1.2019;16:00;4;2;2
streda;2.1.2019;17:00;4;2;2
streda;2.1.2019;18:00;12;6;6
streda;2.1.2019;19:00;2;1;1
streda;2.1.2019;20:00;0;0;0
streda;2.1.2019;21:00;1;0;1
streda;2.1.2019;22:00;0;0;0
streda;2.1.2019;23:00;1;0;1
štvrtok;3.1.2019;0:00;0;0;0
štvrtok;3.1.2019;1:00;0;0;0
štvrtok;3.1.2019;2:00;0;0;0
štvrtok;3.1.2019;3:00;0;0;0
štvrtok;3.1.2019;4:00;1;0;1
štvrtok;3.1.2019;5:00;0;0;0
štvrtok;3.1.2019;6:00;5;1;4
štvrtok;3.1.2019;7:00;2;0;2
štvrtok;3.1.2019;8:00;3;1;2
štvrtok;3.1.2019;9:00;6;3;3
štvrtok;3.1.2019;10:00;4;2;2
štvrtok;3.1.2019;11:00;8;7;1
štvrtok;3.1.2019;12:00;6;2;4
štvrtok;3.1.2019;13:00;8;4;4
štvrtok;3.1.2019;14:00;9;1;8
štvrtok;3.1.2019;15:00;11;3;8
štvrtok;3.1.2019;16:00;11;3;8
štvrtok;3.1.2019;17:00;9;2;7
štvrtok;3.1.2019;18:00;8;3;5
štvrtok;3.1.2019;19:00;4;0;4
štvrtok;3.1.2019;20:00;1;1;0
štvrtok;3.1.2019;21:00;0;0;0
štvrtok;3.1.2019;22:00;0;0;0
štvrtok;3.1.2019;23:00;1;0;1
piatok;4.1.2019;0:00;0;0;0
piatok;4.1.2019;1:00;0;0;0
piatok;4.1.2019;2:00;0;0;0
piatok;4.1.2019;3:00;0;0;0
piatok;4.1.2019;4:00;0;0;0
piatok;4.1.2019;5:00;2;0;2
piatok;4.1.2019;6:00;3;0;3
piatok;4.1.2019;7:00;1;0;1
piatok;4.1.2019;8:00;3;2;1
piatok;4.1.2019;9:00;4;2;2
piatok;4.1.2019;10:00;9;1;8
piatok;4.1.2019;11:00;6;2;4
piatok;4.1.2019;12:00;3;1;2
piatok;4.1.2019;13:00;8;2;6
piatok;4.1.2019;14:00;1;0;1
piatok;4.1.2019;15:00;6;2;4
piatok;4.1.2019;16:00;4;1;3
piatok;4.1.2019;17:00;6;0;6
piatok;4.1.2019;18:00;9;0;9
piatok;4.1.2019;19:00;12;0;12
piatok;4.1.2019;20:00;7;1;6
piatok;4.1.2019;21:00;5;1;4
piatok;4.1.2019;22:00;7;0;7
piatok;4.1.2019;23:00;0;0;0
sobota;5.1.2019;0:00;0;0;0
sobota;5.1.2019;1:00;0;0;0
sobota;5.1.2019;2:00;2;0;2
sobota;5.1.2019;3:00;0;0;0
sobota;5.1.2019;4:00;0;0;0
sobota;5.1.2019;5:00;2;0;2
sobota;5.1.2019;6:00;1;0;1
sobota;5.1.2019;7:00;1;1;0
sobota;5.1.2019;8:00;2;0;2
sobota;5.1.2019;9:00;1;0;1
sobota;5.1.2019;10:00;2;1;1
sobota;5.1.2019;11:00;0;0;0
sobota;5.1.2019;12:00;0;0;0
sobota;5.1.2019;13:00;0;0;0
sobota;5.1.2019;14:00;1;0;1
sobota;5.1.2019;15:00;0;0;0
sobota;5.1.2019;16:00;3;1;2
sobota;5.1.2019;17:00;1;1;0
sobota;5.1.2019;18:00;1;0;1
sobota;5.1.2019;19:00;0;0;0
sobota;5.1.2019;20:00;1;0;1
sobota;5.1.2019;21:00;0;0;0
sobota;5.1.2019;22:00;1;1;0
sobota;5.1.2019;23:00;3;0;3
nedeľa;6.1.2019;0:00;0;0;0
nedeľa;6.1.2019;1:00;0;0;0
nedeľa;6.1.2019;2:00;0;0;0
nedeľa;6.1.2019;3:00;0;0;0
nedeľa;6.1.2019;4:00;0;0;0
nedeľa;6.1.2019;5:00;1;0;1
nedeľa;6.1.2019;6:00;0;0;0
nedeľa;6.1.2019;7:00;0;0;0
nedeľa;6.1.2019;8:00;0;0;0
nedeľa;6.1.2019;9:00;4;3;1
nedeľa;6.1.2019;10:00;4;3;1
nedeľa;6.1.2019;11:00;2;0;2
nedeľa;6.1.2019;12:00;7;5;2
nedeľa;6.1.2019;13:00;3;1;2
nedeľa;6.1.2019;14:00;5;2;3
nedeľa;6.1.2019;15:00;4;3;1
nedeľa;6.1.2019;16:00;5;2;3
nedeľa;6.1.2019;17:00;4;0;4
nedeľa;6.1.2019;18:00;3;0;3
nedeľa;6.1.2019;19:00;3;1;2
nedeľa;6.1.2019;20:00;0;0;0
nedeľa;6.1.2019;21:00;0;0;0
nedeľa;6.1.2019;22:00;2;0;2
nedeľa;6.1.2019;23:00;0;0;0
pondelok;7.1.2019;0:00;0;0;0
pondelok;7.1.2019;1:00;0;0;0
pondelok;7.1.2019;2:00;0;0;0
pondelok;7.1.2019;3:00;0;0;0
pondelok;7.1.2019;4:00;0;0;0
pondelok;7.1.2019;5:00;1;0;1
pondelok;7.1.2019;6:00;2;0;2
pondelok;7.1.2019;7:00;4;1;3
pondelok;7.1.2019;8:00;6;1;5
pondelok;7.1.2019;9:00;5;1;4
pondelok;7.1.2019;10:00;3;2;1
pondelok;7.1.2019;11:00;3;2;1
pondelok;7.1.2019;12:00;3;0;3
pondelok;7.1.2019;13:00;8;5;3
pondelok;7.1.2019;14:00;4;1;3
pondelok;7.1.2019;15:00;5;2;3
pondelok;7.1.2019;16:00;6;3;3
pondelok;7.1.2019;17:00;9;4;5
pondelok;7.1.2019;18:00;7;5;2
pondelok;7.1.2019;19:00;5;4;1
pondelok;7.1.2019;20:00;2;0;2
pondelok;7.1.2019;21:00;0;0;0
pondelok;7.1.2019;22:00;0;0;0
pondelok;7.1.2019;23:00;2;0;2
utorok;8.1.2019;0:00;0;0;0
utorok;8.1.2019;1:00;0;0;0
utorok;8.1.2019;2:00;0;0;0
utorok;8.1.2019;3:00;0;0;0
utorok;8.1.2019;4:00;0;0;0
utorok;8.1.2019;5:00;2;0;2
utorok;8.1.2019;6:00;2;1;1
utorok;8.1.2019;7:00;6;0;6
utorok;8.1.2019;8:00;16;2;14
utorok;8.1.2019;9:00;64;1;63
utorok;8.1.2019;10:00;41;1;40
utorok;8.1.2019;11:00;11;2;9
utorok;8.1.2019;12:00;23;2;21
utorok;8.1.2019;13:00;11;1;10
utorok;8.1.2019;14:00;2;0;2
utorok;8.1.2019;15:00;3;1;2
utorok;8.1.2019;16:00;9;4;5
utorok;8.1.2019;17:00;15;5;10
utorok;8.1.2019;18:00;19;3;16
utorok;8.1.2019;19:00;8;1;7
utorok;8.1.2019;20:00;2;0;2
utorok;8.1.2019;21:00;1;0;1
utorok;8.1.2019;22:00;1;0;1
utorok;8.1.2019;23:00;0;0;0
streda;9.1.2019;0:00;0;0;0
streda;9.1.2019;1:00;0;0;0
streda;9.1.2019;2:00;2;0;2
streda;9.1.2019;3:00;0;0;0
streda;9.1.2019;4:00;0;0;0
streda;9.1.2019;5:00;4;0;4
streda;9.1.2019;6:00;4;0;4
streda;9.1.2019;7:00;4;0;4
streda;9.1.2019;8:00;16;2;14
streda;9.1.2019;9:00;8;1;7
streda;9.1.2019;10:00;4;1;3
streda;9.1.2019;11:00;5;1;4
streda;9.1.2019;12:00;10;3;7
streda;9.1.2019;13:00;4;1;3
streda;9.1.2019;14:00;3;0;3
streda;9.1.2019;15:00;3;0;3
streda;9.1.2019;16:00;9;1;8
streda;9.1.2019;17:00;6;0;6
streda;9.1.2019;18:00;5;2;3
streda;9.1.2019;19:00;6;1;5
streda;9.1.2019;20:00;5;5;0
streda;9.1.2019;21:00;0;0;0
streda;9.1.2019;22:00;0;0;0
streda;9.1.2019;23:00;2;2;0
štvrtok;10.1.2019;0:00;0;0;0
štvrtok;10.1.2019;1:00;0;0;0
štvrtok;10.1.2019;2:00;0;0;0
štvrtok;10.1.2019;3:00;0;0;0
štvrtok;10.1.2019;4:00;0;0;0
štvrtok;10.1.2019;5:00;0;0;0
štvrtok;10.1.2019;6:00;2;0;2
štvrtok;10.1.2019;7:00;5;0;5
štvrtok;10.1.2019;8:00;8;1;7
štvrtok;10.1.2019;9:00;6;2;4
štvrtok;10.1.2019;10:00;1;0;1
štvrtok;10.1.2019;11:00;3;0;3
štvrtok;10.1.2019;12:00;4;2;2
štvrtok;10.1.2019;13:00;3;0;3
štvrtok;10.1.2019;14:00;7;2;5
štvrtok;10.1.2019;15:00;10;9;1
štvrtok;10.1.2019;16:00;9;4;5
štvrtok;10.1.2019;17:00;10;4;6
štvrtok;10.1.2019;18:00;4;2;2
štvrtok;10.1.2019;19:00;6;2;4
štvrtok;10.1.2019;20:00;1;0;1
štvrtok;10.1.2019;21:00;1;1;0
štvrtok;10.1.2019;22:00;5;1;4
štvrtok;10.1.2019;23:00;0;0;0
piatok;11.1.2019;0:00;1;0;1
piatok;11.1.2019;1:00;0;0;0
piatok;11.1.2019;2:00;0;0;0
piatok;11.1.2019;3:00;0;0;0
piatok;11.1.2019;4:00;0;0;0
piatok;11.1.2019;5:00;0;0;0
piatok;11.1.2019;6:00;6;1;5
piatok;11.1.2019;7:00;5;1;4
piatok;11.1.2019;8:00;17;5;12
piatok;11.1.2019;9:00;6;4;2
piatok;11.1.2019;10:00;2;1;1
piatok;11.1.2019;11:00;1;0;1
piatok;11.1.2019;12:00;5;2;3
piatok;11.1.2019;13:00;1;1;0
piatok;11.1.2019;14:00;3;1;2
piatok;11.1.2019;15:00;9;8;1
piatok;11.1.2019;16:00;8;4;4
piatok;11.1.2019;17:00;9;3;6
piatok;11.1.2019;18:00;3;1;2
piatok;11.1.2019;19:00;1;0;1
piatok;11.1.2019;20:00;4;1;3
piatok;11.1.2019;21:00;6;0;6
piatok;11.1.2019;22:00;3;0;3
piatok;11.1.2019;23:00;4;0;4
sobota;12.1.2019;0:00;3;0;3
sobota;12.1.2019;1:00;1;0;1
sobota;12.1.2019;2:00;0;0;0
sobota;12.1.2019;3:00;0;0;0
sobota;12.1.2019;4:00;1;1;0
sobota;12.1.2019;5:00;0;0;0
sobota;12.1.2019;6:00;0;0;0
sobota;12.1.2019;7:00;0;0;0
sobota;12.1.2019;8:00;1;1;0
sobota;12.1.2019;9:00;0;0;0
sobota;12.1.2019;10:00;4;3;1
sobota;12.1.2019;11:00;1;0;1
sobota;12.1.2019;12:00;4;1;3
sobota;12.1.2019;13:00;6;3;3
sobota;12.1.2019;14:00;9;5;4
sobota;12.1.2019;15:00;2;1;1
sobota;12.1.2019;16:00;10;3;7
sobota;12.1.2019;17:00;5;2;3
sobota;12.1.2019;18:00;8;0;8
sobota;12.1.2019;19:00;6;1;5
sobota;12.1.2019;20:00;4;0;4
sobota;12.1.2019;21:00;3;2;1
sobota;12.1.2019;22:00;1;0;1
sobota;12.1.2019;23:00;2;2;0
nedeľa;13.1.2019;0:00;0;0;0
nedeľa;13.1.2019;1:00;0;0;0
nedeľa;13.1.2019;2:00;3;1;2
nedeľa;13.1.2019;3:00;3;0;3
nedeľa;13.1.2019;4:00;1;0;1
nedeľa;13.1.2019;5:00;0;0;0
nedeľa;13.1.2019;6:00;1;1;0
nedeľa;13.1.2019;7:00;1;1;0
nedeľa;13.1.2019;8:00;1;1;0
nedeľa;13.1.2019;9:00;5;5;0
nedeľa;13.1.2019;10:00;16;9;7
nedeľa;13.1.2019;11:00;24;16;8
nedeľa;13.1.2019;12:00;18;9;9
nedeľa;13.1.2019;13:00;29;17;12
nedeľa;13.1.2019;14:00;35;17;18
nedeľa;13.1.2019;15:00;22;12;10
nedeľa;13.1.2019;16:00;6;2;4
nedeľa;13.1.2019;17:00;3;2;1
nedeľa;13.1.2019;18:00;4;1;3
nedeľa;13.1.2019;19:00;2;0;2
nedeľa;13.1.2019;20:00;2;1;1
nedeľa;13.1.2019;21:00;0;0;0
nedeľa;13.1.2019;22:00;0;0;0
nedeľa;13.1.2019;23:00;1;0;1
pondelok;14.1.2019;0:00;1;0;1
pondelok;14.1.2019;1:00;0;0;0
pondelok;14.1.2019;2:00;0;0;0
pondelok;14.1.2019;3:00;0;0;0
pondelok;14.1.2019;4:00;0;0;0
pondelok;14.1.2019;5:00;4;1;3
pondelok;14.1.2019;6:00;2;1;1
pondelok;14.1.2019;7:00;10;1;9
pondelok;14.1.2019;8:00;8;4;4
pondelok;14.1.2019;9:00;6;2;4
pondelok;14.1.2019;10:00;4;2;2
pondelok;14.1.2019;11:00;5;0;5
pondelok;14.1.2019;12:00;4;3;1
pondelok;14.1.2019;13:00;6;1;5
pondelok;14.1.2019;14:00;4;1;3
pondelok;14.1.2019;15:00;7;4;3
pondelok;14.1.2019;16:00;11;6;5
pondelok;14.1.2019;17:00;8;7;1
pondelok;14.1.2019;18:00;7;4;3
pondelok;14.1.2019;19:00;4;2;2
pondelok;14.1.2019;20:00;1;0;1
pondelok;14.1.2019;21:00;0;0;0
pondelok;14.1.2019;22:00;2;1;1
pondelok;14.1.2019;23:00;1;0;1
utorok;15.1.2019;0:00;1;1;0
utorok;15.1.2019;1:00;0;0;0
utorok;15.1.2019;2:00;0;0;0
utorok;15.1.2019;3:00;0;0;0
utorok;15.1.2019;4:00;0;0;0
utorok;15.1.2019;5:00;3;0;3
utorok;15.1.2019;6:00;4;1;3
utorok;15.1.2019;7:00;8;2;6
utorok;15.1.2019;8:00;11;6;5
utorok;15.1.2019;9:00;9;4;5
utorok;15.1.2019;10:00;5;2;3
utorok;15.1.2019;11:00;5;2;3
utorok;15.1.2019;12:00;1;1;0
utorok;15.1.2019;13:00;10;6;4
utorok;15.1.2019;14:00;14;10;4
utorok;15.1.2019;15:00;7;1;6
utorok;15.1.2019;16:00;15;9;6
utorok;15.1.2019;17:00;13;2;11
utorok;15.1.2019;18:00;5;2;3
utorok;15.1.2019;19:00;6;4;2
utorok;15.1.2019;20:00;5;4;1
utorok;15.1.2019;21:00;2;0;2
utorok;15.1.2019;22:00;0;0;0
utorok;15.1.2019;23:00;1;1;0
streda;16.1.2019;0:00;0;0;0
streda;16.1.2019;1:00;0;0;0
streda;16.1.2019;2:00;0;0;0
streda;16.1.2019;3:00;0;0;0
streda;16.1.2019;4:00;0;0;0
streda;16.1.2019;5:00;1;0;1
streda;16.1.2019;6:00;5;1;4
streda;16.1.2019;7:00;10;4;6
streda;16.1.2019;8:00;21;8;13
streda;16.1.2019;9:00;13;3;10
streda;16.1.2019;10:00;10;6;4
streda;16.1.2019;11:00;6;4;2
streda;16.1.2019;12:00;10;5;5
streda;16.1.2019;13:00;10;6;4
streda;16.1.2019;14:00;11;4;7
streda;16.1.2019;15:00;26;11;15
streda;16.1.2019;16:00;23;10;13
streda;16.1.2019;17:00;29;19;10
streda;16.1.2019;18:00;16;10;6
streda;16.1.2019;19:00;10;4;6
streda;16.1.2019;20:00;5;2;3
streda;16.1.2019;21:00;2;2;0
streda;16.1.2019;22:00;5;2;3
streda;16.1.2019;23:00;1;1;0
štvrtok;17.1.2019;0:00;1;1;0
štvrtok;17.1.2019;1:00;0;0;0
štvrtok;17.1.2019;2:00;0;0;0
štvrtok;17.1.2019;3:00;0;0;0
štvrtok;17.1.2019;4:00;0;0;0
štvrtok;17.1.2019;5:00;2;1;1
štvrtok;17.1.2019;6:00;4;0;4
štvrtok;17.1.2019;7:00;17;9;8
štvrtok;17.1.2019;8:00;24;15;9
štvrtok;17.1.2019;9:00;19;3;16
štvrtok;17.1.2019;10:00;12;3;9
štvrtok;17.1.2019;11:00;19;10;9
štvrtok;17.1.2019;12:00;15;5;10
štvrtok;17.1.2019;13:00;18;9;9
štvrtok;17.1.2019;14:00;24;19;5
štvrtok;17.1.2019;15:00;42;24;18
štvrtok;17.1.2019;16:00;40;20;20
štvrtok;17.1.2019;17:00;31;19;12
štvrtok;17.1.2019;18:00;15;6;9
štvrtok;17.1.2019;19:00;6;5;1
štvrtok;17.1.2019;20:00;7;3;4
štvrtok;17.1.2019;21:00;2;1;1
štvrtok;17.1.2019;22:00;1;0;1
štvrtok;17.1.2019;23:00;2;2;0
piatok;18.1.2019;0:00;0;0;0
piatok;18.1.2019;1:00;1;0;1
piatok;18.1.2019;2:00;0;0;0
piatok;18.1.2019;3:00;0;0;0
piatok;18.1.2019;4:00;0;0;0
piatok;18.1.2019;5:00;0;0;0
piatok;18.1.2019;6:00;7;2;5
piatok;18.1.2019;7:00;9;1;8
piatok;18.1.2019;8:00;23;10;13
piatok;18.1.2019;9:00;9;4;5
piatok;18.1.2019;10:00;8;6;2
piatok;18.1.2019;11:00;10;8;2
piatok;18.1.2019;12:00;10;3;7
piatok;18.1.2019;13:00;6;3;3
piatok;18.1.2019;14:00;23;17;6
piatok;18.1.2019;15:00;25;13;12
piatok;18.1.2019;16:00;26;8;18
piatok;18.1.2019;17:00;16;10;6
piatok;18.1.2019;18:00;11;6;5
piatok;18.1.2019;19:00;5;2;3
piatok;18.1.2019;20:00;7;3;4
piatok;18.1.2019;21:00;3;1;2
piatok;18.1.2019;22:00;2;2;0
piatok;18.1.2019;23:00;0;0;0
sobota;19.1.2019;0:00;2;1;1
sobota;19.1.2019;1:00;0;0;0
sobota;19.1.2019;2:00;0;0;0
sobota;19.1.2019;3:00;0;0;0
sobota;19.1.2019;4:00;1;0;1
sobota;19.1.2019;5:00;2;0;2
sobota;19.1.2019;6:00;3;3;0
sobota;19.1.2019;7:00;1;1;0
sobota;19.1.2019;8:00;6;3;3
sobota;19.1.2019;9:00;5;4;1
sobota;19.1.2019;10:00;15;13;2
sobota;19.1.2019;11:00;13;9;4
sobota;19.1.2019;12:00;23;10;13
sobota;19.1.2019;13:00;18;9;9
sobota;19.1.2019;14:00;17;8;9
sobota;19.1.2019;15:00;23;14;9
sobota;19.1.2019;16:00;11;5;6
sobota;19.1.2019;17:00;9;5;4
sobota;19.1.2019;18:00;3;2;1
sobota;19.1.2019;19:00;6;2;4
sobota;19.1.2019;20:00;3;3;0
sobota;19.1.2019;21:00;1;0;1
sobota;19.1.2019;22:00;1;1;0
sobota;19.1.2019;23:00;1;1;0
nedeľa;20.1.2019;0:00;0;0;0
nedeľa;20.1.2019;1:00;0;0;0
nedeľa;20.1.2019;2:00;0;0;0
nedeľa;20.1.2019;3:00;0;0;0
nedeľa;20.1.2019;4:00;0;0;0
nedeľa;20.1.2019;5:00;1;0;1
nedeľa;20.1.2019;6:00;0;0;0
nedeľa;20.1.2019;7:00;1;1;0
nedeľa;20.1.2019;8:00;1;1;0
nedeľa;20.1.2019;9:00;7;4;3
nedeľa;20.1.2019;10:00;10;7;3
nedeľa;20.1.2019;11:00;23;10;13
nedeľa;20.1.2019;12:00;22;12;10
nedeľa;20.1.2019;13:00;25;10;15
nedeľa;20.1.2019;14:00;30;11;19
nedeľa;20.1.2019;15:00;24;13;11
nedeľa;20.1.2019;16:00;18;8;10
nedeľa;20.1.2019;17:00;10;7;3
nedeľa;20.1.2019;18:00;5;3;2
nedeľa;20.1.2019;19:00;6;3;3
nedeľa;20.1.2019;20:00;5;4;1
nedeľa;20.1.2019;21:00;0;0;0
nedeľa;20.1.2019;22:00;0;0;0
nedeľa;20.1.2019;23:00;1;0;1
pondelok;21.1.2019;0:00;0;0;0
pondelok;21.1.2019;1:00;0;0;0
pondelok;21.1.2019;2:00;0;0;0
pondelok;21.1.2019;3:00;0;0;0
pondelok;21.1.2019;4:00;0;0;0
pondelok;21.1.2019;5:00;1;0;1
pondelok;21.1.2019;6:00;4;1;3
pondelok;21.1.2019;7:00;7;1;6
pondelok;21.1.2019;8:00;20;8;12
pondelok;21.1.2019;9:00;7;3;4
pondelok;21.1.2019;10:00;2;1;1
pondelok;21.1.2019;11:00;8;2;6
pondelok;21.1.2019;12:00;11;6;5
pondelok;21.1.2019;13:00;15;9;6
pondelok;21.1.2019;14:00;17;8;9
pondelok;21.1.2019;15:00;16;9;7
pondelok;21.1.2019;16:00;38;21;17
pondelok;21.1.2019;17:00;17;12;5
pondelok;21.1.2019;18:00;11;4;7
pondelok;21.1.2019;19:00;8;3;5
pondelok;21.1.2019;20:00;4;0;4
pondelok;21.1.2019;21:00;0;0;0
pondelok;21.1.2019;22:00;6;2;4
pondelok;21.1.2019;23:00;0;0;0
utorok;22.1.2019;0:00;0;0;0
utorok;22.1.2019;1:00;0;0;0
utorok;22.1.2019;2:00;0;0;0
utorok;22.1.2019;3:00;0;0;0
utorok;22.1.2019;4:00;0;0;0
utorok;22.1.2019;5:00;2;0;2
utorok;22.1.2019;6:00;3;0;3
utorok;22.1.2019;7:00;9;3;6
utorok;22.1.2019;8:00;10;3;7
utorok;22.1.2019;9:00;13;6;7
utorok;22.1.2019;10:00;4;1;3
utorok;22.1.2019;11:00;2;1;1
utorok;22.1.2019;12:00;6;1;5
utorok;22.1.2019;13:00;10;6;4
utorok;22.1.2019;14:00;8;4;4
utorok;22.1.2019;15:00;7;2;5
utorok;22.1.2019;16:00;18;9;9
utorok;22.1.2019;17:00;14;10;4
utorok;22.1.2019;18:00;12;5;7
utorok;22.1.2019;19:00;6;4;2
utorok;22.1.2019;20:00;3;2;1
utorok;22.1.2019;21:00;6;3;3
utorok;22.1.2019;22:00;4;1;3
utorok;22.1.2019;23:00;0;0;0
streda;23.1.2019;0:00;0;0;0
streda;23.1.2019;1:00;0;0;0
streda;23.1.2019;2:00;0;0;0
streda;23.1.2019;3:00;0;0;0
streda;23.1.2019;4:00;0;0;0
streda;23.1.2019;5:00;1;0;1
streda;23.1.2019;6:00;3;1;2
streda;23.1.2019;7:00;9;1;8
streda;23.1.2019;8:00;12;5;7
streda;23.1.2019;9:00;5;0;5
streda;23.1.2019;10:00;4;3;1
streda;23.1.2019;11:00;4;3;1
streda;23.1.2019;12:00;2;1;1
streda;23.1.2019;13:00;5;3;2
streda;23.1.2019;14:00;5;1;4
streda;23.1.2019;15:00;7;3;4
streda;23.1.2019;16:00;16;10;6
streda;23.1.2019;17:00;14;7;7
streda;23.1.2019;18:00;13;1;12
streda;23.1.2019;19:00;5;2;3
streda;23.1.2019;20:00;4;3;1
streda;23.1.2019;21:00;0;0;0
streda;23.1.2019;22:00;2;1;1
streda;23.1.2019;23:00;4;0;4
štvrtok;24.1.2019;0:00;0;0;0
štvrtok;24.1.2019;1:00;0;0;0
štvrtok;24.1.2019;2:00;0;0;0
štvrtok;24.1.2019;3:00;0;0;0
štvrtok;24.1.2019;4:00;0;0;0
štvrtok;24.1.2019;5:00;0;0;0
štvrtok;24.1.2019;6:00;3;0;3
štvrtok;24.1.2019;7:00;6;0;6
štvrtok;24.1.2019;8:00;13;3;10
štvrtok;24.1.2019;9:00;7;3;4
štvrtok;24.1.2019;10:00;9;4;5
štvrtok;24.1.2019;11:00;11;4;7
štvrtok;24.1.2019;12:00;14;6;8
štvrtok;24.1.2019;13:00;15;6;9
štvrtok;24.1.2019;14:00;5;2;3
štvrtok;24.1.2019;15:00;6;1;5
štvrtok;24.1.2019;16:00;17;12;5
štvrtok;24.1.2019;17:00;10;3;7
štvrtok;24.1.2019;18:00;14;7;7
štvrtok;24.1.2019;19:00;9;7;2
štvrtok;24.1.2019;20:00;2;0;2
štvrtok;24.1.2019;21:00;2;0;2
štvrtok;24.1.2019;22:00;1;1;0
štvrtok;24.1.2019;23:00;2;0;2
piatok;25.1.2019;0:00;0;0;0
piatok;25.1.2019;1:00;1;0;1
piatok;25.1.2019;2:00;0;0;0
piatok;25.1.2019;3:00;0;0;0
piatok;25.1.2019;4:00;0;0;0
piatok;25.1.2019;5:00;1;0;1
piatok;25.1.2019;6:00;5;1;4
piatok;25.1.2019;7:00;7;3;4
piatok;25.1.2019;8:00;9;1;8
piatok;25.1.2019;9:00;10;3;7
piatok;25.1.2019;10:00;3;2;1
piatok;25.1.2019;11:00;7;3;4
piatok;25.1.2019;12:00;8;4;4
piatok;25.1.2019;13:00;3;2;1
piatok;25.1.2019;14:00;11;6;5
piatok;25.1.2019;15:00;21;9;12
piatok;25.1.2019;16:00;16;8;8
piatok;25.1.2019;17:00;20;8;12
piatok;25.1.2019;18:00;8;4;4
piatok;25.1.2019;19:00;9;5;4
piatok;25.1.2019;20:00;5;4;1
piatok;25.1.2019;21:00;2;2;0
piatok;25.1.2019;22:00;1;1;0
piatok;25.1.2019;23:00;0;0;0
sobota;26.1.2019;0:00;0;0;0
sobota;26.1.2019;1:00;0;0;0
sobota;26.1.2019;2:00;0;0;0
sobota;26.1.2019;3:00;0;0;0
sobota;26.1.2019;4:00;0;0;0
sobota;26.1.2019;5:00;1;0;1
sobota;26.1.2019;6:00;0;0;0
sobota;26.1.2019;7:00;0;0;0
sobota;26.1.2019;8:00;3;1;2
sobota;26.1.2019;9:00;6;4;2
sobota;26.1.2019;10:00;9;5;4
sobota;26.1.2019;11:00;10;4;6
sobota;26.1.2019;12:00;8;2;6
sobota;26.1.2019;13:00;9;0;9
sobota;26.1.2019;14:00;64;1;63
sobota;26.1.2019;15:00;24;2;22
sobota;26.1.2019;16:00;19;3;16
sobota;26.1.2019;17:00;38;2;36
sobota;26.1.2019;18:00;16;2;14
sobota;26.1.2019;19:00;22;0;22
sobota;26.1.2019;20:00;19;1;18
sobota;26.1.2019;21:00;3;0;3
sobota;26.1.2019;22:00;4;1;3
sobota;26.1.2019;23:00;5;2;3
nedeľa;27.1.2019;0:00;7;1;6
nedeľa;27.1.2019;1:00;0;0;0
nedeľa;27.1.2019;2:00;3;0;3
nedeľa;27.1.2019;3:00;0;0;0
nedeľa;27.1.2019;4:00;0;0;0
nedeľa;27.1.2019;5:00;1;0;1
nedeľa;27.1.2019;6:00;2;0;2
nedeľa;27.1.2019;7:00;0;0;0
nedeľa;27.1.2019;8:00;2;1;1
nedeľa;27.1.2019;9:00;3;0;3
nedeľa;27.1.2019;10:00;3;0;3
nedeľa;27.1.2019;11:00;3;1;2
nedeľa;27.1.2019;12:00;7;3;4
nedeľa;27.1.2019;13:00;1;1;0
nedeľa;27.1.2019;14:00;7;2;5
nedeľa;27.1.2019;15:00;5;1;4
nedeľa;27.1.2019;16:00;10;2;8
nedeľa;27.1.2019;17:00;13;0;13
nedeľa;27.1.2019;18:00;3;1;2
nedeľa;27.1.2019;19:00;2;0;2
nedeľa;27.1.2019;20:00;0;0;0
nedeľa;27.1.2019;21:00;1;0;1
nedeľa;27.1.2019;22:00;0;0;0
nedeľa;27.1.2019;23:00;0;0;0
pondelok;28.1.2019;0:00;0;0;0
pondelok;28.1.2019;1:00;0;0;0
pondelok;28.1.2019;2:00;0;0;0
pondelok;28.1.2019;3:00;0;0;0
pondelok;28.1.2019;4:00;0;0;0
pondelok;28.1.2019;5:00;2;0;2
pondelok;28.1.2019;6:00;2;0;2
pondelok;28.1.2019;7:00;8;2;6
pondelok;28.1.2019;8:00;4;3;1
pondelok;28.1.2019;9:00;1;0;1
pondelok;28.1.2019;10:00;0;0;0
pondelok;28.1.2019;11:00;2;0;2
pondelok;28.1.2019;12:00;0;0;0
pondelok;28.1.2019;13:00;1;1;0
pondelok;28.1.2019;14:00;2;0;2
pondelok;28.1.2019;15:00;2;2;0
pondelok;28.1.2019;16:00;6;2;4
pondelok;28.1.2019;17:00;4;3;1
pondelok;28.1.2019;18:00;4;3;1
pondelok;28.1.2019;19:00;3;2;1
pondelok;28.1.2019;20:00;2;1;1
pondelok;28.1.2019;21:00;0;0;0
pondelok;28.1.2019;22:00;1;0;1
pondelok;28.1.2019;23:00;2;0;2
utorok;29.1.2019;0:00;0;0;0
utorok;29.1.2019;1:00;0;0;0
utorok;29.1.2019;2:00;0;0;0
utorok;29.1.2019;3:00;0;0;0
utorok;29.1.2019;4:00;0;0;0
utorok;29.1.2019;5:00;1;0;1
utorok;29.1.2019;6:00;2;1;1
utorok;29.1.2019;7:00;3;1;2
utorok;29.1.2019;8:00;7;3;4
utorok;29.1.2019;9:00;5;0;5
utorok;29.1.2019;10:00;2;1;1
utorok;29.1.2019;11:00;8;4;4
utorok;29.1.2019;12:00;10;4;6
utorok;29.1.2019;13:00;2;1;1
utorok;29.1.2019;14:00;3;3;0
utorok;29.1.2019;15:00;5;2;3
utorok;29.1.2019;16:00;6;4;2
utorok;29.1.2019;17:00;7;3;4
utorok;29.1.2019;18:00;2;0;2
utorok;29.1.2019;19:00;1;1;0
utorok;29.1.2019;20:00;1;1;0
utorok;29.1.2019;21:00;1;1;0
utorok;29.1.2019;22:00;0;0;0
utorok;29.1.2019;23:00;4;1;3
streda;30.1.2019;0:00;0;0;0
streda;30.1.2019;1:00;0;0;0
streda;30.1.2019;2:00;0;0;0
streda;30.1.2019;3:00;0;0;0
streda;30.1.2019;4:00;0;0;0
streda;30.1.2019;5:00;1;0;1
streda;30.1.2019;6:00;1;0;1
streda;30.1.2019;7:00;5;1;4
streda;30.1.2019;8:00;7;1;6
streda;30.1.2019;9:00;0;0;0
streda;30.1.2019;10:00;0;0;0
streda;30.1.2019;11:00;5;2;3
streda;30.1.2019;12:00;2;2;0
streda;30.1.2019;13:00;2;0;2
streda;30.1.2019;14:00;5;2;3
streda;30.1.2019;15:00;3;1;2
streda;30.1.2019;16:00;8;5;3
streda;30.1.2019;17:00;7;5;2
streda;30.1.2019;18:00;4;1;3
streda;30.1.2019;19:00;1;1;0
streda;30.1.2019;20:00;1;1;0
streda;30.1.2019;21:00;2;2;0
streda;30.1.2019;22:00;1;1;0
streda;30.1.2019;23:00;0;0;0
štvrtok;31.1.2019;0:00;1;1;0
štvrtok;31.1.2019;1:00;0;0;0
štvrtok;31.1.2019;2:00;0;0;0
štvrtok;31.1.2019;3:00;0;0;0
štvrtok;31.1.2019;4:00;0;0;0
štvrtok;31.1.2019;5:00;0;0;0
štvrtok;31.1.2019;6:00;2;0;2
štvrtok;31.1.2019;7:00;4;0;4
štvrtok;31.1.2019;8:00;7;1;6
štvrtok;31.1.2019;9:00;5;1;4
štvrtok;31.1.2019;10:00;1;0;1
štvrtok;31.1.2019;11:00;1;0;1
štvrtok;31.1.2019;12:00;2;1;1
štvrtok;31.1.2019;13:00;3;0;3
štvrtok;31.1.2019;14:00;3;0;3
štvrtok;31.1.2019;15:00;7;5;2
štvrtok;31.1.2019;16:00;6;5;1
štvrtok;31.1.2019;17:00;5;2;3
štvrtok;31.1.2019;18:00;9;4;5
štvrtok;31.1.2019;19:00;2;1;1
štvrtok;31.1.2019;20:00;5;2;3
štvrtok;31.1.2019;21:00;1;1;0
štvrtok;31.1.2019;22:00;1;1;0
štvrtok;31.1.2019;23:00;3;0;3
piatok;1.2.2019;0:00;1;0;1
piatok;1.2.2019;1:00;0;0;0
piatok;1.2.2019;2:00;0;0;0
piatok;1.2.2019;3:00;0;0;0
piatok;1.2.2019;4:00;0;0;0
piatok;1.2.2019;5:00;2;0;2
piatok;1.2.2019;6:00;3;0;3
piatok;1.2.2019;7:00;4;1;3
piatok;1.2.2019;8:00;5;0;5
piatok;1.2.2019;9:00;5;1;4
piatok;1.2.2019;10:00;4;2;2
piatok;1.2.2019;11:00;4;2;2
piatok;1.2.2019;12:00;5;3;2
piatok;1.2.2019;13:00;4;1;3
piatok;1.2.2019;14:00;2;0;2
piatok;1.2.2019;15:00;3;2;1
piatok;1.2.2019;16:00;5;3;2
piatok;1.2.2019;17:00;4;3;1
piatok;1.2.2019;18:00;2;2;0
piatok;1.2.2019;19:00;3;2;1
piatok;1.2.2019;20:00;1;0;1
piatok;1.2.2019;21:00;2;0;2
piatok;1.2.2019;22:00;2;1;1
piatok;1.2.2019;23:00;0;0;0
sobota;2.2.2019;0:00;1;0;1
sobota;2.2.2019;1:00;0;0;0
sobota;2.2.2019;2:00;0;0;0
sobota;2.2.2019;3:00;0;0;0
sobota;2.2.2019;4:00;0;0;0
sobota;2.2.2019;5:00;3;0;3
sobota;2.2.2019;6:00;0;0;0
sobota;2.2.2019;7:00;0;0;0
sobota;2.2.2019;8:00;2;1;1
sobota;2.2.2019;9:00;4;3;1
sobota;2.2.2019;10:00;9;6;3
sobota;2.2.2019;11:00;14;8;6
sobota;2.2.2019;12:00;31;15;16
sobota;2.2.2019;13:00;22;12;10
sobota;2.2.2019;14:00;28;14;14
sobota;2.2.2019;15:00;25;11;14
sobota;2.2.2019;16:00;18;6;12
sobota;2.2.2019;17:00;13;5;8
sobota;2.2.2019;18:00;2;1;1
sobota;2.2.2019;19:00;4;1;3
sobota;2.2.2019;20:00;1;1;0
sobota;2.2.2019;21:00;1;0;1
sobota;2.2.2019;22:00;1;1;0
sobota;2.2.2019;23:00;1;0;1
nedeľa;3.2.2019;0:00;0;0;0
nedeľa;3.2.2019;1:00;0;0;0
nedeľa;3.2.2019;2:00;0;0;0
nedeľa;3.2.2019;3:00;0;0;0
nedeľa;3.2.2019;4:00;0;0;0
nedeľa;3.2.2019;5:00;0;0;0
nedeľa;3.2.2019;6:00;0;0;0
nedeľa;3.2.2019;7:00;0;0;0
nedeľa;3.2.2019;8:00;1;1;0
nedeľa;3.2.2019;9:00;6;3;3
nedeľa;3.2.2019;10:00;13;9;4
nedeľa;3.2.2019;11:00;12;10;2
nedeľa;3.2.2019;12:00;24;9;15
nedeľa;3.2.2019;13:00;28;17;11
nedeľa;3.2.2019;14:00;13;5;8
nedeľa;3.2.2019;15:00;1;0;1
nedeľa;3.2.2019;16:00;3;3;0
nedeľa;3.2.2019;17:00;4;0;4
nedeľa;3.2.2019;18:00;1;0;1
nedeľa;3.2.2019;19:00;4;0;4
nedeľa;3.2.2019;20:00;0;0;0
nedeľa;3.2.2019;21:00;1;1;0
nedeľa;3.2.2019;22:00;0;0;0
nedeľa;3.2.2019;23:00;0;0;0
pondelok;4.2.2019;0:00;0;0;0
pondelok;4.2.2019;1:00;0;0;0
pondelok;4.2.2019;2:00;0;0;0
pondelok;4.2.2019;3:00;0;0;0
pondelok;4.2.2019;4:00;0;0;0
pondelok;4.2.2019;5:00;1;0;1
pondelok;4.2.2019;6:00;2;0;2
pondelok;4.2.2019;7:00;8;2;6
pondelok;4.2.2019;8:00;10;4;6
pondelok;4.2.2019;9:00;2;1;1
pondelok;4.2.2019;10:00;4;1;3
pondelok;4.2.2019;11:00;1;0;1
pondelok;4.2.2019;12:00;11;8;3
pondelok;4.2.2019;13:00;7;3;4
pondelok;4.2.2019;14:00;7;3;4
pondelok;4.2.2019;15:00;14;6;8
pondelok;4.2.2019;16:00;24;14;10
pondelok;4.2.2019;17:00;10;7;3
pondelok;4.2.2019;18:00;9;5;4
pondelok;4.2.2019;19:00;9;5;4
pondelok;4.2.2019;20:00;6;5;1
pondelok;4.2.2019;21:00;4;4;0
pondelok;4.2.2019;22:00;1;0;1
pondelok;4.2.2019;23:00;0;0;0
utorok;5.2.2019;0:00;0;0;0
utorok;5.2.2019;1:00;0;0;0
utorok;5.2.2019;2:00;0;0;0
utorok;5.2.2019;3:00;0;0;0
utorok;5.2.2019;4:00;0;0;0
utorok;5.2.2019;5:00;3;1;2
utorok;5.2.2019;6:00;0;0;0
utorok;5.2.2019;7:00;10;1;9
utorok;5.2.2019;8:00;20;5;15
utorok;5.2.2019;9:00;12;4;8
utorok;5.2.2019;10:00;10;5;5
utorok;5.2.2019;11:00;7;3;4
utorok;5.2.2019;12:00;11;6;5
utorok;5.2.2019;13:00;19;10;9
utorok;5.2.2019;14:00;14;6;8
utorok;5.2.2019;15:00;15;10;5
utorok;5.2.2019;16:00;34;17;17
utorok;5.2.2019;17:00;28;18;10
utorok;5.2.2019;18:00;10;7;3
utorok;5.2.2019;19:00;4;3;1
utorok;5.2.2019;20:00;4;2;2
utorok;5.2.2019;21:00;2;1;1
utorok;5.2.2019;22:00;2;0;2
utorok;5.2.2019;23:00;0;0;0
streda;6.2.2019;0:00;0;0;0
streda;6.2.2019;1:00;1;1;0
streda;6.2.2019;2:00;0;0;0
streda;6.2.2019;3:00;0;0;0
streda;6.2.2019;4:00;0;0;0
streda;6.2.2019;5:00;2;0;2
streda;6.2.2019;6:00;3;1;2
streda;6.2.2019;7:00;16;5;11
streda;6.2.2019;8:00;24;9;15
streda;6.2.2019;9:00;10;5;5
streda;6.2.2019;10:00;10;6;4
streda;6.2.2019;11:00;7;4;3
streda;6.2.2019;12:00;14;10;4
streda;6.2.2019;13:00;16;4;12
streda;6.2.2019;14:00;10;6;4
streda;6.2.2019;15:00;28;17;11
streda;6.2.2019;16:00;35;22;13
streda;6.2.2019;17:00;18;10;8
streda;6.2.2019;18:00;17;8;9
streda;6.2.2019;19:00;3;2;1
streda;6.2.2019;20:00;3;3;0
streda;6.2.2019;21:00;4;3;1
streda;6.2.2019;22:00;4;1;3
streda;6.2.2019;23:00;1;1;0
štvrtok;7.2.2019;0:00;0;0;0
štvrtok;7.2.2019;1:00;0;0;0
štvrtok;7.2.2019;2:00;0;0;0
štvrtok;7.2.2019;3:00;0;0;0
štvrtok;7.2.2019;4:00;0;0;0
štvrtok;7.2.2019;5:00;1;0;1
štvrtok;7.2.2019;6:00;2;0;2
štvrtok;7.2.2019;7:00;12;3;9
štvrtok;7.2.2019;8:00;9;2;7
štvrtok;7.2.2019;9:00;8;5;3
štvrtok;7.2.2019;10:00;1;1;0
štvrtok;7.2.2019;11:00;2;1;1
štvrtok;7.2.2019;12:00;2;1;1
štvrtok;7.2.2019;13:00;12;5;7
štvrtok;7.2.2019;14:00;12;7;5
štvrtok;7.2.2019;15:00;18;13;5
štvrtok;7.2.2019;16:00;32;19;13
štvrtok;7.2.2019;17:00;22;10;12
štvrtok;7.2.2019;18:00;14;7;7
štvrtok;7.2.2019;19:00;13;6;7
štvrtok;7.2.2019;20:00;6;1;5
štvrtok;7.2.2019;21:00;5;2;3
štvrtok;7.2.2019;22:00;2;0;2
štvrtok;7.2.2019;23:00;1;0;1
piatok;8.2.2019;0:00;0;0;0
piatok;8.2.2019;1:00;0;0;0
piatok;8.2.2019;2:00;0;0;0
piatok;8.2.2019;3:00;0;0;0
piatok;8.2.2019;4:00;1;0;1
piatok;8.2.2019;5:00;1;0;1
piatok;8.2.2019;6:00;4;2;2
piatok;8.2.2019;7:00;11;5;6
piatok;8.2.2019;8:00;17;7;10
piatok;8.2.2019;9:00;8;5;3
piatok;8.2.2019;10:00;7;2;5
piatok;8.2.2019;11:00;7;2;5
piatok;8.2.2019;12:00;22;14;8
piatok;8.2.2019;13:00;18;7;11
piatok;8.2.2019;14:00;37;22;15
piatok;8.2.2019;15:00;46;30;16
piatok;8.2.2019;16:00;31;18;13
piatok;8.2.2019;17:00;28;19;9
piatok;8.2.2019;18:00;16;6;10
piatok;8.2.2019;19:00;5;3;2
piatok;8.2.2019;20:00;1;0;1
piatok;8.2.2019;21:00;2;1;1
piatok;8.2.2019;22:00;1;1;0
piatok;8.2.2019;23:00;1;0;1
sobota;9.2.2019;0:00;1;0;1
sobota;9.2.2019;1:00;0;0;0
sobota;9.2.2019;2:00;0;0;0
sobota;9.2.2019;3:00;0;0;0
sobota;9.2.2019;4:00;0;0;0
sobota;9.2.2019;5:00;0;0;0
sobota;9.2.2019;6:00;0;0;0
sobota;9.2.2019;7:00;2;1;1
sobota;9.2.2019;8:00;5;3;2
sobota;9.2.2019;9:00;3;2;1
sobota;9.2.2019;10:00;16;8;8
sobota;9.2.2019;11:00;39;30;9
sobota;9.2.2019;12:00;38;21;17
sobota;9.2.2019;13:00;40;26;14
sobota;9.2.2019;14:00;50;24;26
sobota;9.2.2019;15:00;57;29;28
sobota;9.2.2019;16:00;51;26;25
sobota;9.2.2019;17:00;27;9;18
sobota;9.2.2019;18:00;7;4;3
sobota;9.2.2019;19:00;6;0;6
sobota;9.2.2019;20:00;3;2;1
sobota;9.2.2019;21:00;0;0;0
sobota;9.2.2019;22:00;2;0;2
sobota;9.2.2019;23:00;2;0;2
nedeľa;10.2.2019;0:00;0;0;0
nedeľa;10.2.2019;1:00;0;0;0
nedeľa;10.2.2019;2:00;0;0;0
nedeľa;10.2.2019;3:00;0;0;0
nedeľa;10.2.2019;4:00;1;0;1
nedeľa;10.2.2019;5:00;0;0;0
nedeľa;10.2.2019;6:00;2;2;0
nedeľa;10.2.2019;7:00;0;0;0
nedeľa;10.2.2019;8:00;5;1;4
nedeľa;10.2.2019;9:00;6;4;2
nedeľa;10.2.2019;10:00;7;6;1
nedeľa;10.2.2019;11:00;14;8;6
nedeľa;10.2.2019;12:00;13;9;4
nedeľa;10.2.2019;13:00;24;12;12
nedeľa;10.2.2019;14:00;40;19;21
nedeľa;10.2.2019;15:00;52;24;28
nedeľa;10.2.2019;16:00;17;9;8
nedeľa;10.2.2019;17:00;15;7;8
nedeľa;10.2.2019;18:00;11;3;8
nedeľa;10.2.2019;19:00;4;2;2
nedeľa;10.2.2019;20:00;4;4;0
nedeľa;10.2.2019;21:00;1;1;0
nedeľa;10.2.2019;22:00;0;0;0
nedeľa;10.2.2019;23:00;0;0;0
pondelok;11.2.2019;0:00;0;0;0
pondelok;11.2.2019;1:00;0;0;0
pondelok;11.2.2019;2:00;0;0;0
pondelok;11.2.2019;3:00;0;0;0
pondelok;11.2.2019;4:00;0;0;0
pondelok;11.2.2019;5:00;2;0;2
pondelok;11.2.2019;6:00;1;0;1
pondelok;11.2.2019;7:00;12;4;8
pondelok;11.2.2019;8:00;21;10;11
pondelok;11.2.2019;9:00;12;3;9
pondelok;11.2.2019;10:00;2;1;1
pondelok;11.2.2019;11:00;4;2;2
pondelok;11.2.2019;12:00;8;4;4
pondelok;11.2.2019;13:00;6;1;5
pondelok;11.2.2019;14:00;12;2;10
pondelok;11.2.2019;15:00;11;5;6
pondelok;11.2.2019;16:00;24;9;15
pondelok;11.2.2019;17:00;27;10;17
pondelok;11.2.2019;18:00;12;8;4
pondelok;11.2.2019;19:00;3;1;2
pondelok;11.2.2019;20:00;2;2;0
pondelok;11.2.2019;21:00;2;2;0
pondelok;11.2.2019;22:00;0;0;0
pondelok;11.2.2019;23:00;0;0;0
utorok;12.2.2019;0:00;0;0;0
utorok;12.2.2019;1:00;0;0;0
utorok;12.2.2019;2:00;0;0;0
utorok;12.2.2019;3:00;0;0;0
utorok;12.2.2019;4:00;0;0;0
utorok;12.2.2019;5:00;2;0;2
utorok;12.2.2019;6:00;3;1;2
utorok;12.2.2019;7:00;12;4;8
utorok;12.2.2019;8:00;19;4;15
utorok;12.2.2019;9:00;13;7;6
utorok;12.2.2019;10:00;7;5;2
utorok;12.2.2019;11:00;1;1;0
utorok;12.2.2019;12:00;5;4;1
utorok;12.2.2019;13:00;5;0;5
utorok;12.2.2019;14:00;6;1;5
utorok;12.2.2019;15:00;8;2;6
utorok;12.2.2019;16:00;19;10;9
utorok;12.2.2019;17:00;22;14;8
utorok;12.2.2019;18:00;5;0;5
utorok;12.2.2019;19:00;5;1;4
utorok;12.2.2019;20:00;6;4;2
utorok;12.2.2019;21:00;1;1;0
utorok;12.2.2019;22:00;3;2;1
utorok;12.2.2019;23:00;0;0;0
streda;13.2.2019;0:00;1;0;1
streda;13.2.2019;1:00;0;0;0
streda;13.2.2019;2:00;1;0;1
streda;13.2.2019;3:00;0;0;0
streda;13.2.2019;4:00;1;0;1
streda;13.2.2019;5:00;2;0;2
streda;13.2.2019;6:00;2;1;1
streda;13.2.2019;7:00;8;4;4
streda;13.2.2019;8:00;18;9;9
streda;13.2.2019;9:00;12;7;5
streda;13.2.2019;10:00;4;1;3
streda;13.2.2019;11:00;2;1;1
streda;13.2.2019;12:00;8;5;3
streda;13.2.2019;13:00;14;9;5
streda;13.2.2019;14:00;22;13;9
streda;13.2.2019;15:00;26;15;11
streda;13.2.2019;16:00;30;18;12
streda;13.2.2019;17:00;26;13;13
streda;13.2.2019;18:00;24;16;8
streda;13.2.2019;19:00;10;2;8
streda;13.2.2019;20:00;2;0;2
streda;13.2.2019;21:00;4;2;2
streda;13.2.2019;22:00;0;0;0
streda;13.2.2019;23:00;3;1;2
štvrtok;14.2.2019;0:00;0;0;0
štvrtok;14.2.2019;1:00;0;0;0
štvrtok;14.2.2019;2:00;0;0;0
štvrtok;14.2.2019;3:00;0;0;0
štvrtok;14.2.2019;4:00;0;0;0
štvrtok;14.2.2019;5:00;2;0;2
štvrtok;14.2.2019;6:00;1;0;1
štvrtok;14.2.2019;7:00;11;4;7
štvrtok;14.2.2019;8:00;26;13;13
štvrtok;14.2.2019;9:00;19;11;8
štvrtok;14.2.2019;10:00;19;14;5
štvrtok;14.2.2019;11:00;15;5;10
štvrtok;14.2.2019;12:00;16;6;10
štvrtok;14.2.2019;13:00;19;6;13
štvrtok;14.2.2019;14:00;29;24;5
štvrtok;14.2.2019;15:00;35;22;13
štvrtok;14.2.2019;16:00;46;27;19
štvrtok;14.2.2019;17:00;26;14;12
štvrtok;14.2.2019;18:00;15;9;6
štvrtok;14.2.2019;19:00;13;4;9
štvrtok;14.2.2019;20:00;7;3;4
štvrtok;14.2.2019;21:00;2;0;2
štvrtok;14.2.2019;22:00;4;3;1
štvrtok;14.2.2019;23:00;2;0;2
piatok;15.2.2019;0:00;0;0;0
piatok;15.2.2019;1:00;0;0;0
piatok;15.2.2019;2:00;0;0;0
piatok;15.2.2019;3:00;0;0;0
piatok;15.2.2019;4:00;0;0;0
piatok;15.2.2019;5:00;3;0;3
piatok;15.2.2019;6:00;3;1;2
piatok;15.2.2019;7:00;11;5;6
piatok;15.2.2019;8:00;31;15;16
piatok;15.2.2019;9:00;19;10;9
piatok;15.2.2019;10:00;18;12;6
piatok;15.2.2019;11:00;14;6;8
piatok;15.2.2019;12:00;16;9;7
piatok;15.2.2019;13:00;21;10;11
piatok;15.2.2019;14:00;26;12;14
piatok;15.2.2019;15:00;55;38;17
piatok;15.2.2019;16:00;55;29;26
piatok;15.2.2019;17:00;42;24;18
piatok;15.2.2019;18:00;5;3;2
piatok;15.2.2019;19:00;12;6;6
piatok;15.2.2019;20:00;10;2;8
piatok;15.2.2019;21:00;3;0;3
piatok;15.2.2019;22:00;2;2;0
piatok;15.2.2019;23:00;2;2;0
sobota;16.2.2019;0:00;0;0;0
sobota;16.2.2019;1:00;1;1;0
sobota;16.2.2019;2:00;0;0;0
sobota;16.2.2019;3:00;2;0;2
sobota;16.2.2019;4:00;0;0;0
sobota;16.2.2019;5:00;2;1;1
sobota;16.2.2019;6:00;1;1;0
sobota;16.2.2019;7:00;5;5;0
sobota;16.2.2019;8:00;7;3;4
sobota;16.2.2019;9:00;15;11;4
sobota;16.2.2019;10:00;68;51;17
sobota;16.2.2019;11:00;61;37;24
sobota;16.2.2019;12:00;113;72;41
sobota;16.2.2019;13:00;119;58;61
sobota;16.2.2019;14:00;133;79;54
sobota;16.2.2019;15:00;137;63;74
sobota;16.2.2019;16:00;115;50;65
sobota;16.2.2019;17:00;68;33;35
sobota;16.2.2019;18:00;38;3;35
sobota;16.2.2019;19:00;15;2;13
sobota;16.2.2019;20:00;8;1;7
sobota;16.2.2019;21:00;15;1;14
sobota;16.2.2019;22:00;36;2;34
sobota;16.2.2019;23:00;2;1;1
nedeľa;17.2.2019;0:00;1;0;1
nedeľa;17.2.2019;1:00;0;0;0
nedeľa;17.2.2019;2:00;0;0;0
nedeľa;17.2.2019;3:00;0;0;0
nedeľa;17.2.2019;4:00;0;0;0
nedeľa;17.2.2019;5:00;0;0;0
nedeľa;17.2.2019;6:00;0;0;0
nedeľa;17.2.2019;7:00;1;1;0
nedeľa;17.2.2019;8:00;9;6;3
nedeľa;17.2.2019;9:00;26;20;6
nedeľa;17.2.2019;10:00;46;31;15
nedeľa;17.2.2019;11:00;84;47;37
nedeľa;17.2.2019;12:00;112;70;42
nedeľa;17.2.2019;13:00;124;63;61
nedeľa;17.2.2019;14:00;201;114;87
nedeľa;17.2.2019;15:00;201;103;98
nedeľa;17.2.2019;16:00;142;70;72
nedeľa;17.2.2019;17:00;50;26;24
nedeľa;17.2.2019;18:00;10;5;5
nedeľa;17.2.2019;19:00;2;1;1
nedeľa;17.2.2019;20:00;3;3;0
nedeľa;17.2.2019;21:00;1;0;1
nedeľa;17.2.2019;22:00;0;0;0
nedeľa;17.2.2019;23:00;0;0;0
pondelok;18.2.2019;0:00;0;0;0
pondelok;18.2.2019;1:00;0;0;0
pondelok;18.2.2019;2:00;0;0;0
pondelok;18.2.2019;3:00;0;0;0
pondelok;18.2.2019;4:00;0;0;0
pondelok;18.2.2019;5:00;2;0;2
pondelok;18.2.2019;6:00;7;1;6
pondelok;18.2.2019;7:00;20;10;10
pondelok;18.2.2019;8:00;36;15;21
pondelok;18.2.2019;9:00;14;11;3
pondelok;18.2.2019;10:00;8;4;4
pondelok;18.2.2019;11:00;21;12;9
pondelok;18.2.2019;12:00;32;19;13
pondelok;18.2.2019;13:00;36;17;19
pondelok;18.2.2019;14:00;36;17;19
pondelok;18.2.2019;15:00;65;39;26
pondelok;18.2.2019;16:00;89;56;33
pondelok;18.2.2019;17:00;64;32;32
pondelok;18.2.2019;18:00;30;21;9
pondelok;18.2.2019;19:00;8;1;7
pondelok;18.2.2019;20:00;7;6;1
pondelok;18.2.2019;21:00;3;3;0
pondelok;18.2.2019;22:00;1;0;1
pondelok;18.2.2019;23:00;0;0;0
utorok;19.2.2019;0:00;0;0;0
utorok;19.2.2019;1:00;0;0;0
utorok;19.2.2019;2:00;1;0;1
utorok;19.2.2019;3:00;0;0;0
utorok;19.2.2019;4:00;0;0;0
utorok;19.2.2019;5:00;0;0;0
utorok;19.2.2019;6:00;11;5;6
utorok;19.2.2019;7:00;23;11;12
utorok;19.2.2019;8:00;39;16;23
utorok;19.2.2019;9:00;24;14;10
utorok;19.2.2019;10:00;14;10;4
utorok;19.2.2019;11:00;19;10;9
utorok;19.2.2019;12:00;39;17;22
utorok;19.2.2019;13:00;47;23;24
utorok;19.2.2019;14:00;71;39;32
utorok;19.2.2019;15:00;89;47;42
utorok;19.2.2019;16:00;96;55;41
utorok;19.2.2019;17:00;89;48;41
utorok;19.2.2019;18:00;43;18;25
utorok;19.2.2019;19:00;16;8;8
utorok;19.2.2019;20:00;10;7;3
utorok;19.2.2019;21:00;5;2;3
utorok;19.2.2019;22:00;4;2;2
utorok;19.2.2019;23:00;2;1;1
streda;20.2.2019;0:00;0;0;0
streda;20.2.2019;1:00;0;0;0
streda;20.2.2019;2:00;0;0;0
streda;20.2.2019;3:00;0;0;0
streda;20.2.2019;4:00;0;0;0
streda;20.2.2019;5:00;2;0;2
streda;20.2.2019;6:00;12;3;9
streda;20.2.2019;7:00;25;12;13
streda;20.2.2019;8:00;40;20;20
streda;20.2.2019;9:00;15;9;6
streda;20.2.2019;10:00;22;13;9
streda;20.2.2019;11:00;16;12;4
streda;20.2.2019;12:00;21;14;7
streda;20.2.2019;13:00;38;21;17
streda;20.2.2019;14:00;36;18;18
streda;20.2.2019;15:00;62;31;31
streda;20.2.2019;16:00;91;56;35
streda;20.2.2019;17:00;87;50;37
streda;20.2.2019;18:00;35;23;12
streda;20.2.2019;19:00;20;11;9
streda;20.2.2019;20:00;7;4;3
streda;20.2.2019;21:00;3;1;2
streda;20.2.2019;22:00;1;0;1
streda;20.2.2019;23:00;3;2;1
štvrtok;21.2.2019;0:00;1;1;0
štvrtok;21.2.2019;1:00;2;0;2
štvrtok;21.2.2019;2:00;0;0;0
štvrtok;21.2.2019;3:00;0;0;0
štvrtok;21.2.2019;4:00;0;0;0
štvrtok;21.2.2019;5:00;2;0;2
štvrtok;21.2.2019;6:00;8;2;6
štvrtok;21.2.2019;7:00;24;12;12
štvrtok;21.2.2019;8:00;27;9;18
štvrtok;21.2.2019;9:00;21;10;11
štvrtok;21.2.2019;10:00;20;11;9
štvrtok;21.2.2019;11:00;38;23;15
štvrtok;21.2.2019;12:00;35;18;17
štvrtok;21.2.2019;13:00;42;21;21
štvrtok;21.2.2019;14:00;44;26;18
štvrtok;21.2.2019;15:00;70;43;27
štvrtok;21.2.2019;16:00;69;36;33
štvrtok;21.2.2019;17:00;49;21;28
štvrtok;21.2.2019;18:00;24;11;13
štvrtok;21.2.2019;19:00;13;9;4
štvrtok;21.2.2019;20:00;14;7;7
štvrtok;21.2.2019;21:00;5;3;2
štvrtok;21.2.2019;22:00;3;1;2
štvrtok;21.2.2019;23:00;3;2;1
piatok;22.2.2019;0:00;2;0;2
piatok;22.2.2019;1:00;1;0;1
piatok;22.2.2019;2:00;0;0;0
piatok;22.2.2019;3:00;0;0;0
piatok;22.2.2019;4:00;0;0;0
piatok;22.2.2019;5:00;0;0;0
piatok;22.2.2019;6:00;2;1;1
piatok;22.2.2019;7:00;12;8;4
piatok;22.2.2019;8:00;5;2;3
piatok;22.2.2019;9:00;12;3;9
piatok;22.2.2019;10:00;10;6;4
piatok;22.2.2019;11:00;6;3;3
piatok;22.2.2019;12:00;12;5;7
piatok;22.2.2019;13:00;18;2;16
piatok;22.2.2019;14:00;23;11;12
piatok;22.2.2019;15:00;20;15;5
piatok;22.2.2019;16:00;24;11;13
piatok;22.2.2019;17:00;11;5;6
piatok;22.2.2019;18:00;17;10;7
piatok;22.2.2019;19:00;6;4;2
piatok;22.2.2019;20:00;0;0;0
piatok;22.2.2019;21:00;1;1;0
piatok;22.2.2019;22:00;0;0;0
piatok;22.2.2019;23:00;1;0;1
sobota;23.2.2019;0:00;2;2;0
sobota;23.2.2019;1:00;0;0;0
sobota;23.2.2019;2:00;0;0;0
sobota;23.2.2019;3:00;0;0;0
sobota;23.2.2019;4:00;2;1;1
sobota;23.2.2019;5:00;0;0;0
sobota;23.2.2019;6:00;3;2;1
sobota;23.2.2019;7:00;1;1;0
sobota;23.2.2019;8:00;2;1;1
sobota;23.2.2019;9:00;6;2;4
sobota;23.2.2019;10:00;18;10;8
sobota;23.2.2019;11:00;22;14;8
sobota;23.2.2019;12:00;27;13;14
sobota;23.2.2019;13:00;22;12;10
sobota;23.2.2019;14:00;40;20;20
sobota;23.2.2019;15:00;17;6;11
sobota;23.2.2019;16:00;23;13;10
sobota;23.2.2019;17:00;17;11;6
sobota;23.2.2019;18:00;14;4;10
sobota;23.2.2019;19:00;3;2;1
sobota;23.2.2019;20:00;6;1;5
sobota;23.2.2019;21:00;0;0;0
sobota;23.2.2019;22:00;1;0;1
sobota;23.2.2019;23:00;1;0;1
nedeľa;24.2.2019;0:00;0;0;0
nedeľa;24.2.2019;1:00;2;2;0
nedeľa;24.2.2019;2:00;1;0;1
nedeľa;24.2.2019;3:00;1;1;0
nedeľa;24.2.2019;4:00;0;0;0
nedeľa;24.2.2019;5:00;1;0;1
nedeľa;24.2.2019;6:00;1;1;0
nedeľa;24.2.2019;7:00;1;1;0
nedeľa;24.2.2019;8:00;4;2;2
nedeľa;24.2.2019;9:00;7;4;3
nedeľa;24.2.2019;10:00;11;8;3
nedeľa;24.2.2019;11:00;23;17;6
nedeľa;24.2.2019;12:00;14;8;6
nedeľa;24.2.2019;13:00;23;12;11
nedeľa;24.2.2019;14:00;20;8;12
nedeľa;24.2.2019;15:00;23;9;14
nedeľa;24.2.2019;16:00;15;7;8
nedeľa;24.2.2019;17:00;5;2;3
nedeľa;24.2.2019;18:00;3;2;1
nedeľa;24.2.2019;19:00;2;0;2
nedeľa;24.2.2019;20:00;1;1;0
nedeľa;24.2.2019;21:00;0;0;0
nedeľa;24.2.2019;22:00;0;0;0
nedeľa;24.2.2019;23:00;0;0;0
pondelok;25.2.2019;0:00;0;0;0
pondelok;25.2.2019;1:00;0;0;0
pondelok;25.2.2019;2:00;0;0;0
pondelok;25.2.2019;3:00;0;0;0
pondelok;25.2.2019;4:00;1;0;1
pondelok;25.2.2019;5:00;4;1;3
pondelok;25.2.2019;6:00;7;3;4
pondelok;25.2.2019;7:00;18;11;7
pondelok;25.2.2019;8:00;22;13;9
pondelok;25.2.2019;9:00;20;9;11
pondelok;25.2.2019;10:00;17;10;7
pondelok;25.2.2019;11:00;21;10;11
pondelok;25.2.2019;12:00;34;16;18
pondelok;25.2.2019;13:00;21;9;12
pondelok;25.2.2019;14:00;50;31;19
pondelok;25.2.2019;15:00;56;28;28
pondelok;25.2.2019;16:00;72;35;37
pondelok;25.2.2019;17:00;56;28;28
pondelok;25.2.2019;18:00;32;15;17
pondelok;25.2.2019;19:00;17;11;6
pondelok;25.2.2019;20:00;8;5;3
pondelok;25.2.2019;21:00;3;1;2
pondelok;25.2.2019;22:00;1;0;1
pondelok;25.2.2019;23:00;0;0;0
utorok;26.2.2019;0:00;0;0;0
utorok;26.2.2019;1:00;0;0;0
utorok;26.2.2019;2:00;0;0;0
utorok;26.2.2019;3:00;0;0;0
utorok;26.2.2019;4:00;0;0;0
utorok;26.2.2019;5:00;5;0;5
utorok;26.2.2019;6:00;19;12;7
utorok;26.2.2019;7:00;28;8;20
utorok;26.2.2019;8:00;31;13;18
utorok;26.2.2019;9:00;23;14;9
utorok;26.2.2019;10:00;11;6;5
utorok;26.2.2019;11:00;30;21;9
utorok;26.2.2019;12:00;31;19;12
utorok;26.2.2019;13:00;37;18;19
utorok;26.2.2019;14:00;25;12;13
utorok;26.2.2019;15:00;37;19;18
utorok;26.2.2019;16:00;51;31;20
utorok;26.2.2019;17:00;65;35;30
utorok;26.2.2019;18:00;26;13;13
utorok;26.2.2019;19:00;17;5;12
utorok;26.2.2019;20:00;11;5;6
utorok;26.2.2019;21:00;4;1;3
utorok;26.2.2019;22:00;3;1;2
utorok;26.2.2019;23:00;1;1;0
streda;27.2.2019;0:00;0;0;0
streda;27.2.2019;1:00;0;0;0
streda;27.2.2019;2:00;0;0;0
streda;27.2.2019;3:00;0;0;0
streda;27.2.2019;4:00;0;0;0
streda;27.2.2019;5:00;3;1;2
streda;27.2.2019;6:00;14;5;9
streda;27.2.2019;7:00;24;13;11
streda;27.2.2019;8:00;32;16;16
streda;27.2.2019;9:00;30;16;14
streda;27.2.2019;10:00;38;23;15
streda;27.2.2019;11:00;26;21;5
streda;27.2.2019;12:00;44;20;24
streda;27.2.2019;13:00;50;24;26
streda;27.2.2019;14:00;64;36;28
streda;27.2.2019;15:00;89;43;46
streda;27.2.2019;16:00;88;54;34
streda;27.2.2019;17:00;101;57;44
streda;27.2.2019;18:00;53;22;31
streda;27.2.2019;19:00;19;12;7
streda;27.2.2019;20:00;6;1;5
streda;27.2.2019;21:00;8;2;6
streda;27.2.2019;22:00;7;7;0
streda;27.2.2019;23:00;3;1;2
štvrtok;28.2.2019;0:00;0;0;0
štvrtok;28.2.2019;1:00;0;0;0
štvrtok;28.2.2019;2:00;0;0;0
štvrtok;28.2.2019;3:00;0;0;0
štvrtok;28.2.2019;4:00;0;0;0
štvrtok;28.2.2019;5:00;4;0;4
štvrtok;28.2.2019;6:00;24;17;7
štvrtok;28.2.2019;7:00;36;13;23
štvrtok;28.2.2019;8:00;48;26;22
štvrtok;28.2.2019;9:00;21;10;11
štvrtok;28.2.2019;10:00;56;31;25
štvrtok;28.2.2019;11:00;49;26;23
štvrtok;28.2.2019;12:00;42;24;18
štvrtok;28.2.2019;13:00;52;28;24
štvrtok;28.2.2019;14:00;91;45;46
štvrtok;28.2.2019;15:00;117;62;55
štvrtok;28.2.2019;16:00;119;69;50
štvrtok;28.2.2019;17:00;100;49;51
štvrtok;28.2.2019;18:00;46;18;28
štvrtok;28.2.2019;19:00;17;7;10
štvrtok;28.2.2019;20:00;6;5;1
štvrtok;28.2.2019;21:00;6;5;1
štvrtok;28.2.2019;22:00;1;1;0
štvrtok;28.2.2019;23:00;1;0;1
piatok;1.3.2019;0:00;0;0;0
piatok;1.3.2019;1:00;0;0;0
piatok;1.3.2019;2:00;0;0;0
piatok;1.3.2019;3:00;0;0;0
piatok;1.3.2019;4:00;0;0;0
piatok;1.3.2019;5:00;3;1;2
piatok;1.3.2019;6:00;4;1;3
piatok;1.3.2019;7:00;14;6;8
piatok;1.3.2019;8:00;20;10;10
piatok;1.3.2019;9:00;17;9;8
piatok;1.3.2019;10:00;19;14;5
piatok;1.3.2019;11:00;18;7;11
piatok;1.3.2019;12:00;16;6;10
piatok;1.3.2019;13:00;29;14;15
piatok;1.3.2019;14:00;11;7;4
piatok;1.3.2019;15:00;37;18;19
piatok;1.3.2019;16:00;37;16;21
piatok;1.3.2019;17:00;20;12;8
piatok;1.3.2019;18:00;17;8;9
piatok;1.3.2019;19:00;7;5;2
piatok;1.3.2019;20:00;5;3;2
piatok;1.3.2019;21:00;4;0;4
piatok;1.3.2019;22:00;6;0;6
piatok;1.3.2019;23:00;2;1;1
sobota;2.3.2019;0:00;2;1;1
sobota;2.3.2019;1:00;0;0;0
sobota;2.3.2019;2:00;0;0;0
sobota;2.3.2019;3:00;1;1;0
sobota;2.3.2019;4:00;0;0;0
sobota;2.3.2019;5:00;1;0;1
sobota;2.3.2019;6:00;1;1;0
sobota;2.3.2019;7:00;7;5;2
sobota;2.3.2019;8:00;3;2;1
sobota;2.3.2019;9:00;13;7;6
sobota;2.3.2019;10:00;28;21;7
sobota;2.3.2019;11:00;37;23;14
sobota;2.3.2019;12:00;25;17;8
sobota;2.3.2019;13:00;45;22;23
sobota;2.3.2019;14:00;27;11;16
sobota;2.3.2019;15:00;49;22;27
sobota;2.3.2019;16:00;31;17;14
sobota;2.3.2019;17:00;16;8;8
sobota;2.3.2019;18:00;2;1;1
sobota;2.3.2019;19:00;0;0;0
sobota;2.3.2019;20:00;2;0;2
sobota;2.3.2019;21:00;5;3;2
sobota;2.3.2019;22:00;4;1;3
sobota;2.3.2019;23:00;0;0;0
nedeľa;3.3.2019;0:00;0;0;0
nedeľa;3.3.2019;1:00;1;0;1
nedeľa;3.3.2019;2:00;0;0;0
nedeľa;3.3.2019;3:00;0;0;0
nedeľa;3.3.2019;4:00;0;0;0
nedeľa;3.3.2019;5:00;0;0;0
nedeľa;3.3.2019;6:00;1;1;0
nedeľa;3.3.2019;7:00;3;3;0
nedeľa;3.3.2019;8:00;6;4;2
nedeľa;3.3.2019;9:00;6;6;0
nedeľa;3.3.2019;10:00;36;28;8
nedeľa;3.3.2019;11:00;61;43;18
nedeľa;3.3.2019;12:00;94;56;38
nedeľa;3.3.2019;13:00;93;57;36
nedeľa;3.3.2019;14:00;124;62;62
nedeľa;3.3.2019;15:00;116;57;59
nedeľa;3.3.2019;16:00;127;64;63
nedeľa;3.3.2019;17:00;59;25;34
nedeľa;3.3.2019;18:00;29;15;14
nedeľa;3.3.2019;19:00;4;4;0
nedeľa;3.3.2019;20:00;16;8;8
nedeľa;3.3.2019;21:00;2;2;0
nedeľa;3.3.2019;22:00;0;0;0
nedeľa;3.3.2019;23:00;0;0;0
pondelok;4.3.2019;0:00;1;0;1
pondelok;4.3.2019;1:00;0;0;0
pondelok;4.3.2019;2:00;0;0;0
pondelok;4.3.2019;3:00;0;0;0
pondelok;4.3.2019;4:00;1;0;1
pondelok;4.3.2019;5:00;3;0;3
pondelok;4.3.2019;6:00;8;2;6
pondelok;4.3.2019;7:00;27;15;12
pondelok;4.3.2019;8:00;55;28;27
pondelok;4.3.2019;9:00;33;12;21
pondelok;4.3.2019;10:00;25;14;11
pondelok;4.3.2019;11:00;22;9;13
pondelok;4.3.2019;12:00;38;18;20
pondelok;4.3.2019;13:00;45;27;18
pondelok;4.3.2019;14:00;60;34;26
pondelok;4.3.2019;15:00;75;40;35
pondelok;4.3.2019;16:00;96;53;43
pondelok;4.3.2019;17:00;99;54;45
pondelok;4.3.2019;18:00;35;22;13
pondelok;4.3.2019;19:00;13;6;7
pondelok;4.3.2019;20:00;6;3;3
pondelok;4.3.2019;21:00;8;7;1
pondelok;4.3.2019;22:00;0;0;0
pondelok;4.3.2019;23:00;0;0;0
utorok;5.3.2019;0:00;0;0;0
utorok;5.3.2019;1:00;0;0;0
utorok;5.3.2019;2:00;0;0;0
utorok;5.3.2019;3:00;0;0;0
utorok;5.3.2019;4:00;0;0;0
utorok;5.3.2019;5:00;1;0;1
utorok;5.3.2019;6:00;15;10;5
utorok;5.3.2019;7:00;40;17;23
utorok;5.3.2019;8:00;50;18;32
utorok;5.3.2019;9:00;18;4;14
utorok;5.3.2019;10:00;22;15;7
utorok;5.3.2019;11:00;29;17;12
utorok;5.3.2019;12:00;29;11;18
utorok;5.3.2019;13:00;14;6;8
utorok;5.3.2019;14:00;15;9;6
utorok;5.3.2019;15:00;34;22;12
utorok;5.3.2019;16:00;64;32;32
utorok;5.3.2019;17:00;75;40;35
utorok;5.3.2019;18:00;32;15;17
utorok;5.3.2019;19:00;31;17;14
utorok;5.3.2019;20:00;10;4;6
utorok;5.3.2019;21:00;8;5;3
utorok;5.3.2019;22:00;2;1;1
utorok;5.3.2019;23:00;0;0;0
streda;6.3.2019;0:00;0;0;0
streda;6.3.2019;1:00;0;0;0
streda;6.3.2019;2:00;0;0;0
streda;6.3.2019;3:00;0;0;0
streda;6.3.2019;4:00;0;0;0
streda;6.3.2019;5:00;4;2;2
streda;6.3.2019;6:00;11;5;6
streda;6.3.2019;7:00;29;17;12
streda;6.3.2019;8:00;53;29;24
streda;6.3.2019;9:00;44;20;24
streda;6.3.2019;10:00;43;17;26
streda;6.3.2019;11:00;41;25;16
streda;6.3.2019;12:00;45;22;23
streda;6.3.2019;13:00;64;29;35
streda;6.3.2019;14:00;52;27;25
streda;6.3.2019;15:00;87;49;38
streda;6.3.2019;16:00;103;46;57
streda;6.3.2019;17:00;86;45;41
streda;6.3.2019;18:00;51;25;26
streda;6.3.2019;19:00;22;10;12
streda;6.3.2019;20:00;8;7;1
streda;6.3.2019;21:00;6;4;2
streda;6.3.2019;22:00;5;3;2
streda;6.3.2019;23:00;5;4;1
štvrtok;7.3.2019;0:00;1;0;1
štvrtok;7.3.2019;1:00;0;0;0
štvrtok;7.3.2019;2:00;0;0;0
štvrtok;7.3.2019;3:00;0;0;0
štvrtok;7.3.2019;4:00;1;1;0
štvrtok;7.3.2019;5:00;5;2;3
štvrtok;7.3.2019;6:00;19;12;7
štvrtok;7.3.2019;7:00;44;14;30
štvrtok;7.3.2019;8:00;48;18;30
štvrtok;7.3.2019;9:00;35;21;14
štvrtok;7.3.2019;10:00;22;12;10
štvrtok;7.3.2019;11:00;33;10;23
štvrtok;7.3.2019;12:00;35;20;15
štvrtok;7.3.2019;13:00;30;17;13
štvrtok;7.3.2019;14:00;34;20;14
štvrtok;7.3.2019;15:00;56;28;28
štvrtok;7.3.2019;16:00;85;50;35
štvrtok;7.3.2019;17:00;83;42;41
štvrtok;7.3.2019;18:00;40;23;17
štvrtok;7.3.2019;19:00;9;6;3
štvrtok;7.3.2019;20:00;5;2;3
štvrtok;7.3.2019;21:00;5;2;3
štvrtok;7.3.2019;22:00;4;3;1
štvrtok;7.3.2019;23:00;0;0;0
piatok;8.3.2019;0:00;0;0;0
piatok;8.3.2019;1:00;0;0;0
piatok;8.3.2019;2:00;0;0;0
piatok;8.3.2019;3:00;1;0;1
piatok;8.3.2019;4:00;0;0;0
piatok;8.3.2019;5:00;5;1;4
piatok;8.3.2019;6:00;17;13;4
piatok;8.3.2019;7:00;30;11;19
piatok;8.3.2019;8:00;45;25;20
piatok;8.3.2019;9:00;19;10;9
piatok;8.3.2019;10:00;17;9;8
piatok;8.3.2019;11:00;16;5;11
piatok;8.3.2019;12:00;17;12;5
piatok;8.3.2019;13:00;17;7;10
piatok;8.3.2019;14:00;27;18;9
piatok;8.3.2019;15:00;64;31;33
piatok;8.3.2019;16:00;94;46;48
piatok;8.3.2019;17:00;83;61;22
piatok;8.3.2019;18:00;46;23;23
piatok;8.3.2019;19:00;19;8;11
piatok;8.3.2019;20:00;6;4;2
piatok;8.3.2019;21:00;6;3;3
piatok;8.3.2019;22:00;7;6;1
piatok;8.3.2019;23:00;3;1;2
sobota;9.3.2019;0:00;1;0;1
sobota;9.3.2019;1:00;0;0;0
sobota;9.3.2019;2:00;1;1;0
sobota;9.3.2019;3:00;0;0;0
sobota;9.3.2019;4:00;0;0;0
sobota;9.3.2019;5:00;1;0;1
sobota;9.3.2019;6:00;2;2;0
sobota;9.3.2019;7:00;12;7;5
sobota;9.3.2019;8:00;22;15;7
sobota;9.3.2019;9:00;62;39;23
sobota;9.3.2019;10:00;64;48;16
sobota;9.3.2019;11:00;63;31;32
sobota;9.3.2019;12:00;74;41;33
sobota;9.3.2019;13:00;56;29;27
sobota;9.3.2019;14:00;37;11;26
sobota;9.3.2019;15:00;78;37;41
sobota;9.3.2019;16:00;73;43;30
sobota;9.3.2019;17:00;60;16;44
sobota;9.3.2019;18:00;40;19;21
sobota;9.3.2019;19:00;10;7;3
sobota;9.3.2019;20:00;4;3;1
sobota;9.3.2019;21:00;3;2;1
sobota;9.3.2019;22:00;0;0;0
sobota;9.3.2019;23:00;2;1;1
nedeľa;10.3.2019;0:00;0;0;0
nedeľa;10.3.2019;1:00;0;0;0
nedeľa;10.3.2019;2:00;1;1;0
nedeľa;10.3.2019;3:00;0;0;0
nedeľa;10.3.2019;4:00;0;0;0
nedeľa;10.3.2019;5:00;0;0;0
nedeľa;10.3.2019;6:00;1;1;0
nedeľa;10.3.2019;7:00;7;5;2
nedeľa;10.3.2019;8:00;12;7;5
nedeľa;10.3.2019;9:00;17;9;8
nedeľa;10.3.2019;10:00;23;9;14
nedeľa;10.3.2019;11:00;12;4;8
nedeľa;10.3.2019;12:00;10;6;4
nedeľa;10.3.2019;13:00;5;2;3
nedeľa;10.3.2019;14:00;2;2;0
nedeľa;10.3.2019;15:00;11;8;3
nedeľa;10.3.2019;16:00;23;13;10
nedeľa;10.3.2019;17:00;21;12;9
nedeľa;10.3.2019;18:00;16;6;10
nedeľa;10.3.2019;19:00;7;5;2
nedeľa;10.3.2019;20:00;5;2;3
nedeľa;10.3.2019;21:00;5;3;2
nedeľa;10.3.2019;22:00;1;0;1
nedeľa;10.3.2019;23:00;1;0;1
pondelok;11.3.2019;0:00;0;0;0
pondelok;11.3.2019;1:00;0;0;0
pondelok;11.3.2019;2:00;0;0;0
pondelok;11.3.2019;3:00;0;0;0
pondelok;11.3.2019;4:00;0;0;0
pondelok;11.3.2019;5:00;2;0;2
pondelok;11.3.2019;6:00;9;3;6
pondelok;11.3.2019;7:00;22;16;6
pondelok;11.3.2019;8:00;40;18;22
pondelok;11.3.2019;9:00;15;3;12
pondelok;11.3.2019;10:00;16;9;7
pondelok;11.3.2019;11:00;22;12;10
pondelok;11.3.2019;12:00;13;8;5
pondelok;11.3.2019;13:00;22;11;11
pondelok;11.3.2019;14:00;8;6;2
pondelok;11.3.2019;15:00;13;6;7
pondelok;11.3.2019;16:00;26;12;14
pondelok;11.3.2019;17:00;30;15;15
pondelok;11.3.2019;18:00;25;15;10
pondelok;11.3.2019;19:00;12;6;6
pondelok;11.3.2019;20:00;7;2;5
pondelok;11.3.2019;21:00;2;1;1
pondelok;11.3.2019;22:00;0;0;0
pondelok;11.3.2019;23:00;0;0;0
utorok;12.3.2019;0:00;0;0;0
utorok;12.3.2019;1:00;0;0;0
utorok;12.3.2019;2:00;0;0;0
utorok;12.3.2019;3:00;0;0;0
utorok;12.3.2019;4:00;1;0;1
utorok;12.3.2019;5:00;2;0;2
utorok;12.3.2019;6:00;7;3;4
utorok;12.3.2019;7:00;26;16;10
utorok;12.3.2019;8:00;41;13;28
utorok;12.3.2019;9:00;18;7;11
utorok;12.3.2019;10:00;10;7;3
utorok;12.3.2019;11:00;15;9;6
utorok;12.3.2019;12:00;26;15;11
utorok;12.3.2019;13:00;21;12;9
utorok;12.3.2019;14:00;21;10;11
utorok;12.3.2019;15:00;48;26;22
utorok;12.3.2019;16:00;73;35;38
utorok;12.3.2019;17:00;75;42;33
utorok;12.3.2019;18:00;27;17;10
utorok;12.3.2019;19:00;17;6;11
utorok;12.3.2019;20:00;12;5;7
utorok;12.3.2019;21:00;2;1;1
utorok;12.3.2019;22:00;3;3;0
utorok;12.3.2019;23:00;0;0;0
streda;13.3.2019;0:00;0;0;0
streda;13.3.2019;1:00;0;0;0
streda;13.3.2019;2:00;0;0;0
streda;13.3.2019;3:00;0;0;0
streda;13.3.2019;4:00;1;0;1
streda;13.3.2019;5:00;4;2;2
streda;13.3.2019;6:00;15;5;10
streda;13.3.2019;7:00;19;15;4
streda;13.3.2019;8:00;26;7;19
streda;13.3.2019;9:00;10;6;4
streda;13.3.2019;10:00;6;2;4
streda;13.3.2019;11:00;8;0;8
streda;13.3.2019;12:00;7;3;4
streda;13.3.2019;13:00;12;7;5
streda;13.3.2019;14:00;15;8;7
streda;13.3.2019;15:00;29;16;13
streda;13.3.2019;16:00;42;25;17
streda;13.3.2019;17:00;41;17;24
streda;13.3.2019;18:00;27;10;17
streda;13.3.2019;19:00;9;4;5
streda;13.3.2019;20:00;7;4;3
streda;13.3.2019;21:00;4;2;2
streda;13.3.2019;22:00;1;1;0
streda;13.3.2019;23:00;1;0;1
štvrtok;14.3.2019;0:00;0;0;0
štvrtok;14.3.2019;1:00;0;0;0
štvrtok;14.3.2019;2:00;1;0;1
štvrtok;14.3.2019;3:00;0;0;0
štvrtok;14.3.2019;4:00;2;0;2
štvrtok;14.3.2019;5:00;4;2;2
štvrtok;14.3.2019;6:00;12;4;8
štvrtok;14.3.2019;7:00;21;11;10
štvrtok;14.3.2019;8:00;32;18;14
štvrtok;14.3.2019;9:00;25;9;16
štvrtok;14.3.2019;10:00;20;14;6
štvrtok;14.3.2019;11:00;20;10;10
štvrtok;14.3.2019;12:00;23;9;14
štvrtok;14.3.2019;13:00;12;6;6
štvrtok;14.3.2019;14:00;34;17;17
štvrtok;14.3.2019;15:00;43;21;22
štvrtok;14.3.2019;16:00;54;26;28
štvrtok;14.3.2019;17:00;53;20;33
štvrtok;14.3.2019;18:00;33;17;16
štvrtok;14.3.2019;19:00;15;10;5
štvrtok;14.3.2019;20:00;10;6;4
štvrtok;14.3.2019;21:00;8;3;5
štvrtok;14.3.2019;22:00;2;2;0
štvrtok;14.3.2019;23:00;3;1;2
piatok;15.3.2019;0:00;1;0;1
piatok;15.3.2019;1:00;0;0;0
piatok;15.3.2019;2:00;0;0;0
piatok;15.3.2019;3:00;0;0;0
piatok;15.3.2019;4:00;1;0;1
piatok;15.3.2019;5:00;4;2;2
piatok;15.3.2019;6:00;10;5;5
piatok;15.3.2019;7:00;24;11;13
piatok;15.3.2019;8:00;25;10;15
piatok;15.3.2019;9:00;13;7;6
piatok;15.3.2019;10:00;14;10;4
piatok;15.3.2019;11:00;25;14;11
piatok;15.3.2019;12:00;26;8;18
piatok;15.3.2019;13:00;21;8;13
piatok;15.3.2019;14:00;21;13;8
piatok;15.3.2019;15:00;37;17;20
piatok;15.3.2019;16:00;34;19;15
piatok;15.3.2019;17:00;22;9;13
piatok;15.3.2019;18:00;18;11;7
piatok;15.3.2019;19:00;11;0;11
piatok;15.3.2019;20:00;4;2;2
piatok;15.3.2019;21:00;0;0;0
piatok;15.3.2019;22:00;0;0;0
piatok;15.3.2019;23:00;0;0;0
sobota;16.3.2019;0:00;1;1;0
sobota;16.3.2019;1:00;1;1;0
sobota;16.3.2019;2:00;0;0;0
sobota;16.3.2019;3:00;0;0;0
sobota;16.3.2019;4:00;0;0;0
sobota;16.3.2019;5:00;0;0;0
sobota;16.3.2019;6:00;1;1;0
sobota;16.3.2019;7:00;0;0;0
sobota;16.3.2019;8:00;6;2;4
sobota;16.3.2019;9:00;6;3;3
sobota;16.3.2019;10:00;6;2;4
sobota;16.3.2019;11:00;6;3;3
sobota;16.3.2019;12:00;13;8;5
sobota;16.3.2019;13:00;16;6;10
sobota;16.3.2019;14:00;20;8;12
sobota;16.3.2019;15:00;18;13;5
sobota;16.3.2019;16:00;16;9;7
sobota;16.3.2019;17:00;12;6;6
sobota;16.3.2019;18:00;13;5;8
sobota;16.3.2019;19:00;10;1;9
sobota;16.3.2019;20:00;2;0;2
sobota;16.3.2019;21:00;0;0;0
sobota;16.3.2019;22:00;3;0;3
sobota;16.3.2019;23:00;0;0;0
nedeľa;17.3.2019;0:00;1;0;1
nedeľa;17.3.2019;1:00;3;1;2
nedeľa;17.3.2019;2:00;1;0;1
nedeľa;17.3.2019;3:00;1;1;0
nedeľa;17.3.2019;4:00;0;0;0
nedeľa;17.3.2019;5:00;1;1;0
nedeľa;17.3.2019;6:00;3;2;1
nedeľa;17.3.2019;7:00;5;3;2
nedeľa;17.3.2019;8:00;11;8;3
nedeľa;17.3.2019;9:00;36;27;9
nedeľa;17.3.2019;10:00;87;67;20
nedeľa;17.3.2019;11:00;136;94;42
nedeľa;17.3.2019;12:00;173;119;54
nedeľa;17.3.2019;13:00;256;150;106
nedeľa;17.3.2019;14:00;376;231;145
nedeľa;17.3.2019;15:00;424;241;183
nedeľa;17.3.2019;16:00;387;197;190
nedeľa;17.3.2019;17:00;237;106;131
nedeľa;17.3.2019;18:00;82;44;38
nedeľa;17.3.2019;19:00;15;6;9
nedeľa;17.3.2019;20:00;6;4;2
nedeľa;17.3.2019;21:00;7;1;6
nedeľa;17.3.2019;22:00;3;3;0
nedeľa;17.3.2019;23:00;0;0;0
pondelok;18.3.2019;0:00;0;0;0
pondelok;18.3.2019;1:00;0;0;0
pondelok;18.3.2019;2:00;0;0;0
pondelok;18.3.2019;3:00;0;0;0
pondelok;18.3.2019;4:00;0;0;0
pondelok;18.3.2019;5:00;3;2;1
pondelok;18.3.2019;6:00;8;4;4
pondelok;18.3.2019;7:00;20;9;11
pondelok;18.3.2019;8:00;27;13;14
pondelok;18.3.2019;9:00;15;6;9
pondelok;18.3.2019;10:00;6;3;3
pondelok;18.3.2019;11:00;14;6;8
pondelok;18.3.2019;12:00;7;5;2
pondelok;18.3.2019;13:00;6;2;4
pondelok;18.3.2019;14:00;18;13;5
pondelok;18.3.2019;15:00;24;11;13
pondelok;18.3.2019;16:00;44;21;23
pondelok;18.3.2019;17:00;54;30;24
pondelok;18.3.2019;18:00;26;17;9
pondelok;18.3.2019;19:00;11;6;5
pondelok;18.3.2019;20:00;5;4;1
pondelok;18.3.2019;21:00;4;3;1
pondelok;18.3.2019;22:00;2;1;1
pondelok;18.3.2019;23:00;2;2;0
utorok;19.3.2019;0:00;0;0;0
utorok;19.3.2019;1:00;0;0;0
utorok;19.3.2019;2:00;0;0;0
utorok;19.3.2019;3:00;0;0;0
utorok;19.3.2019;4:00;1;0;1
utorok;19.3.2019;5:00;3;1;2
utorok;19.3.2019;6:00;20;12;8
utorok;19.3.2019;7:00;33;9;24
utorok;19.3.2019;8:00;43;13;30
utorok;19.3.2019;9:00;25;13;12
utorok;19.3.2019;10:00;17;9;8
utorok;19.3.2019;11:00;23;12;11
utorok;19.3.2019;12:00;18;7;11
utorok;19.3.2019;13:00;26;12;14
utorok;19.3.2019;14:00;22;10;12
utorok;19.3.2019;15:00;48;32;16
utorok;19.3.2019;16:00;60;31;29
utorok;19.3.2019;17:00;50;24;26
utorok;19.3.2019;18:00;41;21;20
utorok;19.3.2019;19:00;13;9;4
utorok;19.3.2019;20:00;7;4;3
utorok;19.3.2019;21:00;6;4;2
utorok;19.3.2019;22:00;5;2;3
utorok;19.3.2019;23:00;1;0;1
streda;20.3.2019;0:00;0;0;0
streda;20.3.2019;1:00;0;0;0
streda;20.3.2019;2:00;0;0;0
streda;20.3.2019;3:00;0;0;0
streda;20.3.2019;4:00;1;0;1
streda;20.3.2019;5:00;3;2;1
streda;20.3.2019;6:00;10;3;7
streda;20.3.2019;7:00;36;15;21
streda;20.3.2019;8:00;46;22;24
streda;20.3.2019;9:00;22;10;12
streda;20.3.2019;10:00;26;15;11
streda;20.3.2019;11:00;31;21;10
streda;20.3.2019;12:00;30;17;13
streda;20.3.2019;13:00;46;21;25
streda;20.3.2019;14:00;42;22;20
streda;20.3.2019;15:00;48;30;18
streda;20.3.2019;16:00;87;48;39
streda;20.3.2019;17:00;73;48;25
streda;20.3.2019;18:00;52;29;23
streda;20.3.2019;19:00;25;13;12
streda;20.3.2019;20:00;10;6;4
streda;20.3.2019;21:00;7;3;4
streda;20.3.2019;22:00;1;0;1
streda;20.3.2019;23:00;2;2;0
štvrtok;21.3.2019;0:00;2;0;2
štvrtok;21.3.2019;1:00;2;1;1
štvrtok;21.3.2019;2:00;0;0;0
štvrtok;21.3.2019;3:00;0;0;0
štvrtok;21.3.2019;4:00;3;0;3
štvrtok;21.3.2019;5:00;4;1;3
štvrtok;21.3.2019;6:00;27;17;10
štvrtok;21.3.2019;7:00;28;15;13
štvrtok;21.3.2019;8:00;48;19;29
štvrtok;21.3.2019;9:00;26;13;13
štvrtok;21.3.2019;10:00;33;21;12
štvrtok;21.3.2019;11:00;29;16;13
štvrtok;21.3.2019;12:00;49;23;26
štvrtok;21.3.2019;13:00;36;16;20
štvrtok;21.3.2019;14:00;52;29;23
štvrtok;21.3.2019;15:00;94;49;45
štvrtok;21.3.2019;16:00;138;88;50
štvrtok;21.3.2019;17:00;141;71;70
štvrtok;21.3.2019;18:00;86;37;49
štvrtok;21.3.2019;19:00;18;8;10
štvrtok;21.3.2019;20:00;14;7;7
štvrtok;21.3.2019;21:00;0;0;0
štvrtok;21.3.2019;22:00;3;2;1
štvrtok;21.3.2019;23:00;6;6;0
piatok;22.3.2019;0:00;1;0;1
piatok;22.3.2019;1:00;0;0;0
piatok;22.3.2019;2:00;0;0;0
piatok;22.3.2019;3:00;0;0;0
piatok;22.3.2019;4:00;1;0;1
piatok;22.3.2019;5:00;3;2;1
piatok;22.3.2019;6:00;13;5;8
piatok;22.3.2019;7:00;28;15;13
piatok;22.3.2019;8:00;32;13;19
piatok;22.3.2019;9:00;39;19;20
piatok;22.3.2019;10:00;32;18;14
piatok;22.3.2019;11:00;55;33;22
piatok;22.3.2019;12:00;49;29;20
piatok;22.3.2019;13:00;80;45;35
piatok;22.3.2019;14:00;109;57;52
piatok;22.3.2019;15:00;146;78;68
piatok;22.3.2019;16:00;180;99;81
piatok;22.3.2019;17:00;174;92;82
piatok;22.3.2019;18:00;71;39;32
piatok;22.3.2019;19:00;27;14;13
piatok;22.3.2019;20:00;9;5;4
piatok;22.3.2019;21:00;11;6;5
piatok;22.3.2019;22:00;7;1;6
piatok;22.3.2019;23:00;2;1;1
sobota;23.3.2019;0:00;0;0;0
sobota;23.3.2019;1:00;2;2;0
sobota;23.3.2019;2:00;2;0;2
sobota;23.3.2019;3:00;0;0;0
sobota;23.3.2019;4:00;0;0;0
sobota;23.3.2019;5:00;2;2;0
sobota;23.3.2019;6:00;7;6;1
sobota;23.3.2019;7:00;10;6;4
sobota;23.3.2019;8:00;25;19;6
sobota;23.3.2019;9:00;83;49;34
sobota;23.3.2019;10:00;208;143;65
sobota;23.3.2019;11:00;257;168;89
sobota;23.3.2019;12:00;283;157;126
sobota;23.3.2019;13:00;299;166;133
sobota;23.3.2019;14:00;388;227;161
sobota;23.3.2019;15:00;336;164;172
sobota;23.3.2019;16:00;345;171;174
sobota;23.3.2019;17:00;282;129;153
sobota;23.3.2019;18:00;111;58;53
sobota;23.3.2019;19:00;37;23;14
sobota;23.3.2019;20:00;10;7;3
sobota;23.3.2019;21:00;4;0;4
sobota;23.3.2019;22:00;7;3;4
sobota;23.3.2019;23:00;1;0;1
nedeľa;24.3.2019;0:00;1;0;1
nedeľa;24.3.2019;1:00;2;2;0
nedeľa;24.3.2019;2:00;0;0;0
nedeľa;24.3.2019;3:00;1;0;1
nedeľa;24.3.2019;4:00;2;1;1
nedeľa;24.3.2019;5:00;0;0;0
nedeľa;24.3.2019;6:00;4;4;0
nedeľa;24.3.2019;7:00;24;16;8
nedeľa;24.3.2019;8:00;47;26;21
nedeľa;24.3.2019;9:00;113;86;27
nedeľa;24.3.2019;10:00;257;149;108
nedeľa;24.3.2019;11:00;233;140;93
nedeľa;24.3.2019;12:00;271;143;128
nedeľa;24.3.2019;13:00;319;153;166
nedeľa;24.3.2019;14:00;409;245;164
nedeľa;24.3.2019;15:00;417;239;178
nedeľa;24.3.2019;16:00;322;161;161
nedeľa;24.3.2019;17:00;239;114;125
nedeľa;24.3.2019;18:00;79;33;46
nedeľa;24.3.2019;19:00;23;10;13
nedeľa;24.3.2019;20:00;11;4;7
nedeľa;24.3.2019;21:00;0;0;0
nedeľa;24.3.2019;22:00;2;1;1
nedeľa;24.3.2019;23:00;0;0;0
pondelok;25.3.2019;0:00;0;0;0
pondelok;25.3.2019;1:00;0;0;0
pondelok;25.3.2019;2:00;0;0;0
pondelok;25.3.2019;3:00;0;0;0
pondelok;25.3.2019;4:00;1;1;0
pondelok;25.3.2019;5:00;6;3;3
pondelok;25.3.2019;6:00;14;7;7
pondelok;25.3.2019;7:00;37;18;19
pondelok;25.3.2019;8:00;43;23;20
pondelok;25.3.2019;9:00;21;10;11
pondelok;25.3.2019;10:00;11;5;6
pondelok;25.3.2019;11:00;18;12;6
pondelok;25.3.2019;12:00;14;8;6
pondelok;25.3.2019;13:00;19;8;11
pondelok;25.3.2019;14:00;14;7;7
pondelok;25.3.2019;15:00;38;24;14
pondelok;25.3.2019;16:00;40;17;23
pondelok;25.3.2019;17:00;58;30;28
pondelok;25.3.2019;18:00;21;9;12
pondelok;25.3.2019;19:00;4;1;3
pondelok;25.3.2019;20:00;5;3;2
pondelok;25.3.2019;21:00;8;5;3
pondelok;25.3.2019;22:00;3;2;1
pondelok;25.3.2019;23:00;2;1;1
utorok;26.3.2019;0:00;0;0;0
utorok;26.3.2019;1:00;0;0;0
utorok;26.3.2019;2:00;0;0;0
utorok;26.3.2019;3:00;0;0;0
utorok;26.3.2019;4:00;1;0;1
utorok;26.3.2019;5:00;4;1;3
utorok;26.3.2019;6:00;24;18;6
utorok;26.3.2019;7:00;43;13;30
utorok;26.3.2019;8:00;35;18;17
utorok;26.3.2019;9:00;18;9;9
utorok;26.3.2019;10:00;23;15;8
utorok;26.3.2019;11:00;27;11;16
utorok;26.3.2019;12:00;30;14;16
utorok;26.3.2019;13:00;14;8;6
utorok;26.3.2019;14:00;16;9;7
utorok;26.3.2019;15:00;35;19;16
utorok;26.3.2019;16:00;70;37;33
utorok;26.3.2019;17:00;62;31;31
utorok;26.3.2019;18:00;35;23;12
utorok;26.3.2019;19:00;17;7;10
utorok;26.3.2019;20:00;7;6;1
utorok;26.3.2019;21:00;3;2;1
utorok;26.3.2019;22:00;1;0;1
utorok;26.3.2019;23:00;1;0;1
streda;27.3.2019;0:00;0;0;0
streda;27.3.2019;1:00;0;0;0
streda;27.3.2019;2:00;0;0;0
streda;27.3.2019;3:00;0;0;0
streda;27.3.2019;4:00;1;0;1
streda;27.3.2019;5:00;5;3;2
streda;27.3.2019;6:00;16;9;7
streda;27.3.2019;7:00;38;13;25
streda;27.3.2019;8:00;37;15;22
streda;27.3.2019;9:00;25;10;15
streda;27.3.2019;10:00;25;16;9
streda;27.3.2019;11:00;25;7;18
streda;27.3.2019;12:00;31;17;14
streda;27.3.2019;13:00;28;18;10
streda;27.3.2019;14:00;27;13;14
streda;27.3.2019;15:00;48;28;20
streda;27.3.2019;16:00;80;45;35
streda;27.3.2019;17:00;81;48;33
streda;27.3.2019;18:00;51;26;25
streda;27.3.2019;19:00;26;6;20
streda;27.3.2019;20:00;6;3;3
streda;27.3.2019;21:00;11;6;5
streda;27.3.2019;22:00;3;0;3
streda;27.3.2019;23:00;3;3;0
štvrtok;28.3.2019;0:00;1;0;1
štvrtok;28.3.2019;1:00;1;0;1
štvrtok;28.3.2019;2:00;0;0;0
štvrtok;28.3.2019;3:00;0;0;0
štvrtok;28.3.2019;4:00;0;0;0
štvrtok;28.3.2019;5:00;4;2;2
štvrtok;28.3.2019;6:00;26;20;6
štvrtok;28.3.2019;7:00;47;16;31
štvrtok;28.3.2019;8:00;39;22;17
štvrtok;28.3.2019;9:00;25;14;11
štvrtok;28.3.2019;10:00;29;17;12
štvrtok;28.3.2019;11:00;24;13;11
štvrtok;28.3.2019;12:00;43;26;17
štvrtok;28.3.2019;13:00;36;17;19
štvrtok;28.3.2019;14:00;54;23;31
štvrtok;28.3.2019;15:00;60;36;24
štvrtok;28.3.2019;16:00;92;47;45
štvrtok;28.3.2019;17:00;100;54;46
štvrtok;28.3.2019;18:00;46;19;27
štvrtok;28.3.2019;19:00;36;11;25
štvrtok;28.3.2019;20:00;8;5;3
štvrtok;28.3.2019;21:00;7;5;2
štvrtok;28.3.2019;22:00;2;1;1
štvrtok;28.3.2019;23:00;1;1;0
piatok;29.3.2019;0:00;2;0;2
piatok;29.3.2019;1:00;0;0;0
piatok;29.3.2019;2:00;0;0;0
piatok;29.3.2019;3:00;1;0;1
piatok;29.3.2019;4:00;1;0;1
piatok;29.3.2019;5:00;4;3;1
piatok;29.3.2019;6:00;22;12;10
piatok;29.3.2019;7:00;46;23;23
piatok;29.3.2019;8:00;51;28;23
piatok;29.3.2019;9:00;38;17;21
piatok;29.3.2019;10:00;55;15;40
piatok;29.3.2019;11:00;36;22;14
piatok;29.3.2019;12:00;57;32;25
piatok;29.3.2019;13:00;74;38;36
piatok;29.3.2019;14:00;92;38;54
piatok;29.3.2019;15:00;129;70;59
piatok;29.3.2019;16:00;154;80;74
piatok;29.3.2019;17:00;168;88;80
piatok;29.3.2019;18:00;80;44;36
piatok;29.3.2019;19:00;31;13;18
piatok;29.3.2019;20:00;8;5;3
piatok;29.3.2019;21:00;14;8;6
piatok;29.3.2019;22:00;1;1;0
piatok;29.3.2019;23:00;1;0;1
sobota;30.3.2019;0:00;0;0;0
sobota;30.3.2019;1:00;2;1;1
sobota;30.3.2019;2:00;0;0;0
sobota;30.3.2019;3:00;1;0;1
sobota;30.3.2019;4:00;0;0;0
sobota;30.3.2019;5:00;1;1;0
sobota;30.3.2019;6:00;8;5;3
sobota;30.3.2019;7:00;11;9;2
sobota;30.3.2019;8:00;30;21;9
sobota;30.3.2019;9:00;72;48;24
sobota;30.3.2019;10:00;151;89;62
sobota;30.3.2019;11:00;184;117;67
sobota;30.3.2019;12:00;249;163;86
sobota;30.3.2019;13:00;271;154;117
sobota;30.3.2019;14:00;334;194;140
sobota;30.3.2019;15:00;371;196;175
sobota;30.3.2019;16:00;375;161;214
sobota;30.3.2019;17:00;259;132;127
sobota;30.3.2019;18:00;124;51;73
sobota;30.3.2019;19:00;31;11;20
sobota;30.3.2019;20:00;19;6;13
sobota;30.3.2019;21:00;8;6;2
sobota;30.3.2019;22:00;6;3;3
sobota;30.3.2019;23:00;2;1;1
nedeľa;31.3.2019;0:00;1;1;0
nedeľa;31.3.2019;1:00;2;2;0
nedeľa;31.3.2019;2:00;0;;
nedeľa;31.3.2019;3:00;0;0;0
nedeľa;31.3.2019;4:00;0;0;0
nedeľa;31.3.2019;5:00;2;0;2
nedeľa;31.3.2019;6:00;2;2;0
nedeľa;31.3.2019;7:00;10;5;5
nedeľa;31.3.2019;8:00;27;19;8
nedeľa;31.3.2019;9:00;59;42;17
nedeľa;31.3.2019;10:00;176;126;50
nedeľa;31.3.2019;11:00;247;148;99
nedeľa;31.3.2019;12:00;297;153;144
nedeľa;31.3.2019;13:00;343;203;140
nedeľa;31.3.2019;14:00;412;214;198
nedeľa;31.3.2019;15:00;457;228;229
nedeľa;31.3.2019;16:00;365;173;192
nedeľa;31.3.2019;17:00;364;186;178
nedeľa;31.3.2019;18:00;176;100;76
nedeľa;31.3.2019;19:00;59;28;31
nedeľa;31.3.2019;20:00;25;14;11
nedeľa;31.3.2019;21:00;10;5;5
nedeľa;31.3.2019;22:00;8;2;6
nedeľa;31.3.2019;23:00;2;0;2
pondelok;1.4.2019;0:00;1;0;1
pondelok;1.4.2019;1:00;0;0;0
pondelok;1.4.2019;2:00;0;0;0
pondelok;1.4.2019;3:00;0;0;0
pondelok;1.4.2019;4:00;0;0;0
pondelok;1.4.2019;5:00;6;3;3
pondelok;1.4.2019;6:00;14;2;12
pondelok;1.4.2019;7:00;32;14;18
pondelok;1.4.2019;8:00;62;27;35
pondelok;1.4.2019;9:00;35;14;21
pondelok;1.4.2019;10:00;34;16;18
pondelok;1.4.2019;11:00;31;17;14
pondelok;1.4.2019;12:00;61;29;32
pondelok;1.4.2019;13:00;80;46;34
pondelok;1.4.2019;14:00;53;25;28
pondelok;1.4.2019;15:00;122;60;62
pondelok;1.4.2019;16:00;137;70;67
pondelok;1.4.2019;17:00;194;104;90
pondelok;1.4.2019;18:00;151;84;67
pondelok;1.4.2019;19:00;68;44;24
pondelok;1.4.2019;20:00;16;10;6
pondelok;1.4.2019;21:00;17;11;6
pondelok;1.4.2019;22:00;6;3;3
pondelok;1.4.2019;23:00;0;0;0
utorok;2.4.2019;0:00;0;0;0
utorok;2.4.2019;1:00;0;0;0
utorok;2.4.2019;2:00;1;0;1
utorok;2.4.2019;3:00;0;0;0
utorok;2.4.2019;4:00;0;0;0
utorok;2.4.2019;5:00;4;1;3
utorok;2.4.2019;6:00;19;8;11
utorok;2.4.2019;7:00;47;21;26
utorok;2.4.2019;8:00;74;36;38
utorok;2.4.2019;9:00;55;23;32
utorok;2.4.2019;10:00;31;21;10
utorok;2.4.2019;11:00;46;19;27
utorok;2.4.2019;12:00;48;29;19
utorok;2.4.2019;13:00;45;24;21
utorok;2.4.2019;14:00;58;36;22
utorok;2.4.2019;15:00;127;73;54
utorok;2.4.2019;16:00;146;91;55
utorok;2.4.2019;17:00;197;123;74
utorok;2.4.2019;18:00;129;59;70
utorok;2.4.2019;19:00;64;32;32
utorok;2.4.2019;20:00;29;13;16
utorok;2.4.2019;21:00;7;5;2
utorok;2.4.2019;22:00;9;7;2
utorok;2.4.2019;23:00;4;0;4
streda;3.4.2019;0:00;3;0;3
streda;3.4.2019;1:00;0;0;0
streda;3.4.2019;2:00;3;0;3
streda;3.4.2019;3:00;0;0;0
streda;3.4.2019;4:00;1;0;1
streda;3.4.2019;5:00;4;1;3
streda;3.4.2019;6:00;13;5;8
streda;3.4.2019;7:00;42;23;19
streda;3.4.2019;8:00;56;29;27
streda;3.4.2019;9:00;35;15;20
streda;3.4.2019;10:00;26;17;9
streda;3.4.2019;11:00;27;14;13
streda;3.4.2019;12:00;18;12;6
streda;3.4.2019;13:00;28;14;14
streda;3.4.2019;14:00;36;15;21
streda;3.4.2019;15:00;61;35;26
streda;3.4.2019;16:00;96;52;44
streda;3.4.2019;17:00;107;63;44
streda;3.4.2019;18:00;80;39;41
streda;3.4.2019;19:00;65;28;37
streda;3.4.2019;20:00;15;7;8
streda;3.4.2019;21:00;12;5;7
streda;3.4.2019;22:00;2;2;0
streda;3.4.2019;23:00;3;1;2
štvrtok;4.4.2019;0:00;0;0;0
štvrtok;4.4.2019;1:00;0;0;0
štvrtok;4.4.2019;2:00;0;0;0
štvrtok;4.4.2019;3:00;0;0;0
štvrtok;4.4.2019;4:00;0;0;0
štvrtok;4.4.2019;5:00;3;1;2
štvrtok;4.4.2019;6:00;19;11;8
štvrtok;4.4.2019;7:00;40;19;21
štvrtok;4.4.2019;8:00;56;27;29
štvrtok;4.4.2019;9:00;44;21;23
štvrtok;4.4.2019;10:00;42;25;17
štvrtok;4.4.2019;11:00;34;18;16
štvrtok;4.4.2019;12:00;44;22;22
štvrtok;4.4.2019;13:00;37;20;17
štvrtok;4.4.2019;14:00;47;24;23
štvrtok;4.4.2019;15:00;75;42;33
štvrtok;4.4.2019;16:00;108;65;43
štvrtok;4.4.2019;17:00;106;68;38
štvrtok;4.4.2019;18:00;79;41;38
štvrtok;4.4.2019;19:00;62;32;30
štvrtok;4.4.2019;20:00;27;11;16
štvrtok;4.4.2019;21:00;10;5;5
štvrtok;4.4.2019;22:00;5;2;3
štvrtok;4.4.2019;23:00;0;0;0
piatok;5.4.2019;0:00;2;1;1
piatok;5.4.2019;1:00;1;0;1
piatok;5.4.2019;2:00;0;0;0
piatok;5.4.2019;3:00;0;0;0
piatok;5.4.2019;4:00;1;0;1
piatok;5.4.2019;5:00;3;2;1
piatok;5.4.2019;6:00;19;9;10
piatok;5.4.2019;7:00;36;18;18
piatok;5.4.2019;8:00;42;13;29
piatok;5.4.2019;9:00;27;16;11
piatok;5.4.2019;10:00;27;16;11
piatok;5.4.2019;11:00;22;9;13
piatok;5.4.2019;12:00;31;16;15
piatok;5.4.2019;13:00;25;14;11
piatok;5.4.2019;14:00;41;20;21
piatok;5.4.2019;15:00;39;18;21
piatok;5.4.2019;16:00;34;16;18
piatok;5.4.2019;17:00;28;16;12
piatok;5.4.2019;18:00;6;3;3
piatok;5.4.2019;19:00;7;3;4
piatok;5.4.2019;20:00;3;3;0
piatok;5.4.2019;21:00;1;0;1
piatok;5.4.2019;22:00;1;0;1
piatok;5.4.2019;23:00;2;0;2
sobota;6.4.2019;0:00;0;0;0
sobota;6.4.2019;1:00;3;3;0
sobota;6.4.2019;2:00;0;0;0
sobota;6.4.2019;3:00;0;0;0
sobota;6.4.2019;4:00;0;0;0
sobota;6.4.2019;5:00;2;0;2
sobota;6.4.2019;6:00;3;3;0
sobota;6.4.2019;7:00;7;2;5
sobota;6.4.2019;8:00;12;6;6
sobota;6.4.2019;9:00;35;22;13
sobota;6.4.2019;10:00;43;28;15
sobota;6.4.2019;11:00;81;52;29
sobota;6.4.2019;12:00;80;45;35
sobota;6.4.2019;13:00;115;72;43
sobota;6.4.2019;14:00;156;93;63
sobota;6.4.2019;15:00;157;87;70
sobota;6.4.2019;16:00;102;49;53
sobota;6.4.2019;17:00;145;54;91
sobota;6.4.2019;18:00;129;50;79
sobota;6.4.2019;19:00;39;21;18
sobota;6.4.2019;20:00;17;9;8
sobota;6.4.2019;21:00;5;2;3
sobota;6.4.2019;22:00;6;0;6
sobota;6.4.2019;23:00;5;0;5
nedeľa;7.4.2019;0:00;0;0;0
nedeľa;7.4.2019;1:00;1;1;0
nedeľa;7.4.2019;2:00;0;0;0
nedeľa;7.4.2019;3:00;0;0;0
nedeľa;7.4.2019;4:00;0;0;0
nedeľa;7.4.2019;5:00;1;0;1
nedeľa;7.4.2019;6:00;6;5;1
nedeľa;7.4.2019;7:00;16;4;12
nedeľa;7.4.2019;8:00;29;18;11
nedeľa;7.4.2019;9:00;57;34;23
nedeľa;7.4.2019;10:00;56;25;31
nedeľa;7.4.2019;11:00;140;70;70
nedeľa;7.4.2019;12:00;150;92;58
nedeľa;7.4.2019;13:00;199;110;89
nedeľa;7.4.2019;14:00;252;156;96
nedeľa;7.4.2019;15:00;307;165;142
nedeľa;7.4.2019;16:00;297;153;144
nedeľa;7.4.2019;17:00;239;92;147
nedeľa;7.4.2019;18:00;132;60;72
nedeľa;7.4.2019;19:00;63;28;35
nedeľa;7.4.2019;20:00;23;11;12
nedeľa;7.4.2019;21:00;5;4;1
nedeľa;7.4.2019;22:00;1;1;0
nedeľa;7.4.2019;23:00;1;1;0
pondelok;8.4.2019;0:00;0;0;0
pondelok;8.4.2019;1:00;0;0;0
pondelok;8.4.2019;2:00;0;0;0
pondelok;8.4.2019;3:00;0;0;0
pondelok;8.4.2019;4:00;2;1;1
pondelok;8.4.2019;5:00;6;4;2
pondelok;8.4.2019;6:00;20;7;13
pondelok;8.4.2019;7:00;62;25;37
pondelok;8.4.2019;8:00;60;36;24
pondelok;8.4.2019;9:00;34;20;14
pondelok;8.4.2019;10:00;37;19;18
pondelok;8.4.2019;11:00;50;38;12
pondelok;8.4.2019;12:00;47;26;21
pondelok;8.4.2019;13:00;83;43;40
pondelok;8.4.2019;14:00;77;40;37
pondelok;8.4.2019;15:00;131;61;70
pondelok;8.4.2019;16:00;202;107;95
pondelok;8.4.2019;17:00;253;150;103
pondelok;8.4.2019;18:00;252;111;141
pondelok;8.4.2019;19:00;112;60;52
pondelok;8.4.2019;20:00;35;20;15
pondelok;8.4.2019;21:00;16;6;10
pondelok;8.4.2019;22:00;11;8;3
pondelok;8.4.2019;23:00;4;2;2
utorok;9.4.2019;0:00;0;0;0
utorok;9.4.2019;1:00;0;0;0
utorok;9.4.2019;2:00;0;0;0
utorok;9.4.2019;3:00;0;0;0
utorok;9.4.2019;4:00;0;0;0
utorok;9.4.2019;5:00;9;6;3
utorok;9.4.2019;6:00;28;13;15
utorok;9.4.2019;7:00;65;22;43
utorok;9.4.2019;8:00;91;46;45
utorok;9.4.2019;9:00;37;23;14
utorok;9.4.2019;10:00;52;27;25
utorok;9.4.2019;11:00;70;40;30
utorok;9.4.2019;12:00;66;27;39
utorok;9.4.2019;13:00;77;37;40
utorok;9.4.2019;14:00;74;35;39
utorok;9.4.2019;15:00;118;71;47
utorok;9.4.2019;16:00;203;126;77
utorok;9.4.2019;17:00;317;195;122
utorok;9.4.2019;18:00;199;99;100
utorok;9.4.2019;19:00;130;55;75
utorok;9.4.2019;20:00;33;16;17
utorok;9.4.2019;21:00;18;8;10
utorok;9.4.2019;22:00;7;4;3
utorok;9.4.2019;23:00;3;3;0
streda;10.4.2019;0:00;0;0;0
streda;10.4.2019;1:00;0;0;0
streda;10.4.2019;2:00;0;0;0
streda;10.4.2019;3:00;0;0;0
streda;10.4.2019;4:00;1;0;1
streda;10.4.2019;5:00;9;8;1
streda;10.4.2019;6:00;13;9;4
streda;10.4.2019;7:00;39;12;27
streda;10.4.2019;8:00;19;13;6
streda;10.4.2019;9:00;8;4;4
streda;10.4.2019;10:00;3;1;2
streda;10.4.2019;11:00;4;3;1
streda;10.4.2019;12:00;4;3;1
streda;10.4.2019;13:00;8;4;4
streda;10.4.2019;14:00;31;9;22
streda;10.4.2019;15:00;29;16;13
streda;10.4.2019;16:00;44;23;21
streda;10.4.2019;17:00;60;32;28
streda;10.4.2019;18:00;41;17;24
streda;10.4.2019;19:00;35;11;24
streda;10.4.2019;20:00;12;10;2
streda;10.4.2019;21:00;14;1;13
streda;10.4.2019;22:00;11;2;9
streda;10.4.2019;23:00;4;3;1
štvrtok;11.4.2019;0:00;3;1;2
štvrtok;11.4.2019;1:00;0;0;0
štvrtok;11.4.2019;2:00;1;0;1
štvrtok;11.4.2019;3:00;0;0;0
štvrtok;11.4.2019;4:00;0;0;0
štvrtok;11.4.2019;5:00;3;1;2
štvrtok;11.4.2019;6:00;4;2;2
štvrtok;11.4.2019;7:00;10;3;7
štvrtok;11.4.2019;8:00;16;10;6
štvrtok;11.4.2019;9:00;10;4;6
štvrtok;11.4.2019;10:00;7;2;5
štvrtok;11.4.2019;11:00;11;6;5
štvrtok;11.4.2019;12:00;8;4;4
štvrtok;11.4.2019;13:00;5;1;4
štvrtok;11.4.2019;14:00;8;4;4
štvrtok;11.4.2019;15:00;8;2;6
štvrtok;11.4.2019;16:00;16;11;5
štvrtok;11.4.2019;17:00;31;17;14
štvrtok;11.4.2019;18:00;30;16;14
štvrtok;11.4.2019;19:00;17;5;12
štvrtok;11.4.2019;20:00;4;3;1
štvrtok;11.4.2019;21:00;7;5;2
štvrtok;11.4.2019;22:00;4;1;3
štvrtok;11.4.2019;23:00;0;0;0
piatok;12.4.2019;0:00;2;2;0
piatok;12.4.2019;1:00;0;0;0
piatok;12.4.2019;2:00;0;0;0
piatok;12.4.2019;3:00;0;0;0
piatok;12.4.2019;4:00;0;0;0
piatok;12.4.2019;5:00;2;1;1
piatok;12.4.2019;6:00;8;4;4
piatok;12.4.2019;7:00;26;14;12
piatok;12.4.2019;8:00;36;20;16
piatok;12.4.2019;9:00;26;13;13
piatok;12.4.2019;10:00;13;5;8
piatok;12.4.2019;11:00;11;3;8
piatok;12.4.2019;12:00;15;6;9
piatok;12.4.2019;13:00;23;9;14
piatok;12.4.2019;14:00;43;22;21
piatok;12.4.2019;15:00;55;29;26
piatok;12.4.2019;16:00;60;32;28
piatok;12.4.2019;17:00;49;25;24
piatok;12.4.2019;18:00;35;11;24
piatok;12.4.2019;19:00;21;12;9
piatok;12.4.2019;20:00;8;6;2
piatok;12.4.2019;21:00;2;1;1
piatok;12.4.2019;22:00;1;0;1
piatok;12.4.2019;23:00;5;0;5
sobota;13.4.2019;0:00;0;0;0
sobota;13.4.2019;1:00;2;1;1
sobota;13.4.2019;2:00;0;0;0
sobota;13.4.2019;3:00;0;0;0
sobota;13.4.2019;4:00;0;0;0
sobota;13.4.2019;5:00;1;0;1
sobota;13.4.2019;6:00;1;1;0
sobota;13.4.2019;7:00;0;0;0
sobota;13.4.2019;8:00;12;8;4
sobota;13.4.2019;9:00;11;7;4
sobota;13.4.2019;10:00;28;20;8
sobota;13.4.2019;11:00;26;15;11
sobota;13.4.2019;12:00;27;15;12
sobota;13.4.2019;13:00;23;16;7
sobota;13.4.2019;14:00;31;11;20
sobota;13.4.2019;15:00;38;14;24
sobota;13.4.2019;16:00;35;18;17
sobota;13.4.2019;17:00;25;10;15
sobota;13.4.2019;18:00;17;7;10
sobota;13.4.2019;19:00;9;6;3
sobota;13.4.2019;20:00;6;4;2
sobota;13.4.2019;21:00;2;1;1
sobota;13.4.2019;22:00;2;0;2
sobota;13.4.2019;23:00;0;0;0
nedeľa;14.4.2019;0:00;3;2;1
nedeľa;14.4.2019;1:00;2;1;1
nedeľa;14.4.2019;2:00;1;1;0
nedeľa;14.4.2019;3:00;0;0;0
nedeľa;14.4.2019;4:00;0;0;0
nedeľa;14.4.2019;5:00;2;1;1
nedeľa;14.4.2019;6:00;3;1;2
nedeľa;14.4.2019;7:00;3;3;0
nedeľa;14.4.2019;8:00;4;3;1
nedeľa;14.4.2019;9:00;9;5;4
nedeľa;14.4.2019;10:00;17;10;7
nedeľa;14.4.2019;11:00;21;6;15
nedeľa;14.4.2019;12:00;34;22;12
nedeľa;14.4.2019;13:00;43;30;13
nedeľa;14.4.2019;14:00;57;37;20
nedeľa;14.4.2019;15:00;62;31;31
nedeľa;14.4.2019;16:00;71;34;37
nedeľa;14.4.2019;17:00;60;37;23
nedeľa;14.4.2019;18:00;61;29;32
nedeľa;14.4.2019;19:00;32;13;19
nedeľa;14.4.2019;20:00;11;7;4
nedeľa;14.4.2019;21:00;4;3;1
nedeľa;14.4.2019;22:00;3;2;1
nedeľa;14.4.2019;23:00;0;0;0
pondelok;15.4.2019;0:00;0;0;0
pondelok;15.4.2019;1:00;0;0;0
pondelok;15.4.2019;2:00;0;0;0
pondelok;15.4.2019;3:00;1;1;0
pondelok;15.4.2019;4:00;0;0;0
pondelok;15.4.2019;5:00;4;1;3
pondelok;15.4.2019;6:00;22;11;11
pondelok;15.4.2019;7:00;44;15;29
pondelok;15.4.2019;8:00;61;32;29
pondelok;15.4.2019;9:00;33;17;16
pondelok;15.4.2019;10:00;28;17;11
pondelok;15.4.2019;11:00;38;14;24
pondelok;15.4.2019;12:00;40;26;14
pondelok;15.4.2019;13:00;52;30;22
pondelok;15.4.2019;14:00;59;29;30
pondelok;15.4.2019;15:00;104;57;47
pondelok;15.4.2019;16:00;190;110;80
pondelok;15.4.2019;17:00;201;126;75
pondelok;15.4.2019;18:00;164;82;82
pondelok;15.4.2019;19:00;89;47;42
pondelok;15.4.2019;20:00;22;9;13
pondelok;15.4.2019;21:00;12;9;3
pondelok;15.4.2019;22:00;3;1;2
pondelok;15.4.2019;23:00;4;1;3
utorok;16.4.2019;0:00;0;0;0
utorok;16.4.2019;1:00;0;0;0
utorok;16.4.2019;2:00;0;0;0
utorok;16.4.2019;3:00;0;0;0
utorok;16.4.2019;4:00;0;0;0
utorok;16.4.2019;5:00;5;1;4
utorok;16.4.2019;6:00;30;15;15
utorok;16.4.2019;7:00;58;24;34
utorok;16.4.2019;8:00;47;23;24
utorok;16.4.2019;9:00;52;21;31
utorok;16.4.2019;10:00;61;43;18
utorok;16.4.2019;11:00;48;27;21
utorok;16.4.2019;12:00;49;24;25
utorok;16.4.2019;13:00;66;27;39
utorok;16.4.2019;14:00;74;40;34
utorok;16.4.2019;15:00;119;67;52
utorok;16.4.2019;16:00;192;107;85
utorok;16.4.2019;17:00;264;170;94
utorok;16.4.2019;18:00;196;91;105
utorok;16.4.2019;19:00;116;57;59
utorok;16.4.2019;20:00;50;22;28
utorok;16.4.2019;21:00;14;5;9
utorok;16.4.2019;22:00;8;3;5
utorok;16.4.2019;23:00;3;1;2
streda;17.4.2019;0:00;0;0;0
streda;17.4.2019;1:00;0;0;0
streda;17.4.2019;2:00;0;0;0
streda;17.4.2019;3:00;0;0;0
streda;17.4.2019;4:00;0;0;0
streda;17.4.2019;5:00;4;1;3
streda;17.4.2019;6:00;26;11;15
streda;17.4.2019;7:00;43;18;25
streda;17.4.2019;8:00;57;34;23
streda;17.4.2019;9:00;42;21;21
streda;17.4.2019;10:00;35;17;18
streda;17.4.2019;11:00;36;18;18
streda;17.4.2019;12:00;48;26;22
streda;17.4.2019;13:00;56;30;26
streda;17.4.2019;14:00;80;43;37
streda;17.4.2019;15:00;121;75;46
streda;17.4.2019;16:00;205;123;82
streda;17.4.2019;17:00;195;120;75
streda;17.4.2019;18:00;159;69;90
streda;17.4.2019;19:00;101;50;51
streda;17.4.2019;20:00;37;23;14
streda;17.4.2019;21:00;8;3;5
streda;17.4.2019;22:00;8;5;3
streda;17.4.2019;23:00;6;3;3
štvrtok;18.4.2019;0:00;1;0;1
štvrtok;18.4.2019;1:00;1;1;0
štvrtok;18.4.2019;2:00;0;0;0
štvrtok;18.4.2019;3:00;2;0;2
štvrtok;18.4.2019;4:00;0;0;0
štvrtok;18.4.2019;5:00;6;2;4
štvrtok;18.4.2019;6:00;25;16;9
štvrtok;18.4.2019;7:00;42;19;23
štvrtok;18.4.2019;8:00;70;39;31
štvrtok;18.4.2019;9:00;43;20;23
štvrtok;18.4.2019;10:00;66;35;31
štvrtok;18.4.2019;11:00;84;49;35
štvrtok;18.4.2019;12:00;82;47;35
štvrtok;18.4.2019;13:00;93;52;41
štvrtok;18.4.2019;14:00;144;85;59
štvrtok;18.4.2019;15:00;164;83;81
štvrtok;18.4.2019;16:00;194;105;89
štvrtok;18.4.2019;17:00;203;103;100
štvrtok;18.4.2019;18:00;167;91;76
štvrtok;18.4.2019;19:00;74;43;31
štvrtok;18.4.2019;20:00;26;12;14
štvrtok;18.4.2019;21:00;5;2;3
štvrtok;18.4.2019;22:00;5;1;4
štvrtok;18.4.2019;23:00;11;4;7
piatok;19.4.2019;0:00;4;1;3
piatok;19.4.2019;1:00;2;1;1
piatok;19.4.2019;2:00;1;0;1
piatok;19.4.2019;3:00;2;0;2
piatok;19.4.2019;4:00;7;2;5
piatok;19.4.2019;5:00;3;2;1
piatok;19.4.2019;6:00;5;5;0
piatok;19.4.2019;7:00;12;8;4
piatok;19.4.2019;8:00;33;21;12
piatok;19.4.2019;9:00;98;64;34
piatok;19.4.2019;10:00;237;157;80
piatok;19.4.2019;11:00;282;176;106
piatok;19.4.2019;12:00;268;156;112
piatok;19.4.2019;13:00;307;182;125
piatok;19.4.2019;14:00;433;242;191
piatok;19.4.2019;15:00;301;151;150
piatok;19.4.2019;16:00;356;168;188
piatok;19.4.2019;17:00;298;148;150
piatok;19.4.2019;18:00;217;96;121
piatok;19.4.2019;19:00;92;37;55
piatok;19.4.2019;20:00;43;23;20
piatok;19.4.2019;21:00;12;1;11
piatok;19.4.2019;22:00;4;0;4
piatok;19.4.2019;23:00;2;2;0
sobota;20.4.2019;0:00;1;1;0
sobota;20.4.2019;1:00;1;1;0
sobota;20.4.2019;2:00;0;0;0
sobota;20.4.2019;3:00;0;0;0
sobota;20.4.2019;4:00;0;0;0
sobota;20.4.2019;5:00;2;1;1
sobota;20.4.2019;6:00;7;5;2
sobota;20.4.2019;7:00;11;7;4
sobota;20.4.2019;8:00;25;13;12
sobota;20.4.2019;9:00;91;58;33
sobota;20.4.2019;10:00;143;107;36
sobota;20.4.2019;11:00;178;105;73
sobota;20.4.2019;12:00;175;98;77
sobota;20.4.2019;13:00;215;130;85
sobota;20.4.2019;14:00;280;129;151
sobota;20.4.2019;15:00;279;138;141
sobota;20.4.2019;16:00;263;126;137
sobota;20.4.2019;17:00;251;124;127
sobota;20.4.2019;18:00;127;65;62
sobota;20.4.2019;19:00;65;31;34
sobota;20.4.2019;20:00;23;12;11
sobota;20.4.2019;21:00;4;3;1
sobota;20.4.2019;22:00;1;0;1
sobota;20.4.2019;23:00;1;1;0
nedeľa;21.4.2019;0:00;1;0;1
nedeľa;21.4.2019;1:00;1;0;1
nedeľa;21.4.2019;2:00;1;0;1
nedeľa;21.4.2019;3:00;1;0;1
nedeľa;21.4.2019;4:00;0;0;0
nedeľa;21.4.2019;5:00;2;1;1
nedeľa;21.4.2019;6:00;10;8;2
nedeľa;21.4.2019;7:00;15;10;5
nedeľa;21.4.2019;8:00;29;20;9
nedeľa;21.4.2019;9:00;96;56;40
nedeľa;21.4.2019;10:00;147;96;51
nedeľa;21.4.2019;11:00;220;111;109
nedeľa;21.4.2019;12:00;211;119;92
nedeľa;21.4.2019;13:00;224;127;97
nedeľa;21.4.2019;14:00;231;120;111
nedeľa;21.4.2019;15:00;268;128;140
nedeľa;21.4.2019;16:00;327;153;174
nedeľa;21.4.2019;17:00;274;130;144
nedeľa;21.4.2019;18:00;198;109;89
nedeľa;21.4.2019;19:00;95;52;43
nedeľa;21.4.2019;20:00;22;8;14
nedeľa;21.4.2019;21:00;3;1;2
nedeľa;21.4.2019;22:00;5;2;3
nedeľa;21.4.2019;23:00;0;0;0
pondelok;22.4.2019;0:00;0;0;0
pondelok;22.4.2019;1:00;0;0;0
pondelok;22.4.2019;2:00;0;0;0
pondelok;22.4.2019;3:00;0;0;0
pondelok;22.4.2019;4:00;0;0;0
pondelok;22.4.2019;5:00;1;0;1
pondelok;22.4.2019;6:00;7;3;4
pondelok;22.4.2019;7:00;14;8;6
pondelok;22.4.2019;8:00;27;19;8
pondelok;22.4.2019;9:00;77;44;33
pondelok;22.4.2019;10:00;182;116;66
pondelok;22.4.2019;11:00;220;133;87
pondelok;22.4.2019;12:00;196;108;88
pondelok;22.4.2019;13:00;230;129;101
pondelok;22.4.2019;14:00;263;163;100
pondelok;22.4.2019;15:00;297;161;136
pondelok;22.4.2019;16:00;263;128;135
pondelok;22.4.2019;17:00;201;110;91
pondelok;22.4.2019;18:00;88;44;44
pondelok;22.4.2019;19:00;51;25;26
pondelok;22.4.2019;20:00;10;7;3
pondelok;22.4.2019;21:00;5;2;3
pondelok;22.4.2019;22:00;2;1;1
pondelok;22.4.2019;23:00;1;0;1
utorok;23.4.2019;0:00;0;0;0
utorok;23.4.2019;1:00;0;0;0
utorok;23.4.2019;2:00;1;0;1
utorok;23.4.2019;3:00;0;0;0
utorok;23.4.2019;4:00;0;0;0
utorok;23.4.2019;5:00;3;1;2
utorok;23.4.2019;6:00;13;8;5
utorok;23.4.2019;7:00;20;10;10
utorok;23.4.2019;8:00;32;13;19
utorok;23.4.2019;9:00;21;9;12
utorok;23.4.2019;10:00;15;7;8
utorok;23.4.2019;11:00;12;2;10
utorok;23.4.2019;12:00;9;6;3
utorok;23.4.2019;13:00;4;4;0
utorok;23.4.2019;14:00;4;2;2
utorok;23.4.2019;15:00;8;2;6
utorok;23.4.2019;16:00;16;8;8
utorok;23.4.2019;17:00;15;8;7
utorok;23.4.2019;18:00;12;6;6
utorok;23.4.2019;19:00;2;1;1
utorok;23.4.2019;20:00;5;0;5
utorok;23.4.2019;21:00;3;2;1
utorok;23.4.2019;22:00;0;0;0
utorok;23.4.2019;23:00;0;0;0
streda;24.4.2019;0:00;2;0;2
streda;24.4.2019;1:00;0;0;0
streda;24.4.2019;2:00;0;0;0
streda;24.4.2019;3:00;0;0;0
streda;24.4.2019;4:00;0;0;0
streda;24.4.2019;5:00;7;3;4
streda;24.4.2019;6:00;7;3;4
streda;24.4.2019;7:00;33;16;17
streda;24.4.2019;8:00;41;18;23
streda;24.4.2019;9:00;23;9;14
streda;24.4.2019;10:00;26;10;16
streda;24.4.2019;11:00;32;21;11
streda;24.4.2019;12:00;20;13;7
streda;24.4.2019;13:00;19;6;13
streda;24.4.2019;14:00;27;11;16
streda;24.4.2019;15:00;51;31;20
streda;24.4.2019;16:00;66;31;35
streda;24.4.2019;17:00;119;76;43
streda;24.4.2019;18:00;88;43;45
streda;24.4.2019;19:00;71;32;39
streda;24.4.2019;20:00;38;17;21
streda;24.4.2019;21:00;18;10;8
streda;24.4.2019;22:00;7;4;3
streda;24.4.2019;23:00;6;4;2
štvrtok;25.4.2019;0:00;3;3;0
štvrtok;25.4.2019;1:00;1;1;0
štvrtok;25.4.2019;2:00;1;0;1
štvrtok;25.4.2019;3:00;0;0;0
štvrtok;25.4.2019;4:00;0;0;0
štvrtok;25.4.2019;5:00;9;4;5
štvrtok;25.4.2019;6:00;41;26;15
štvrtok;25.4.2019;7:00;65;36;29
štvrtok;25.4.2019;8:00;86;42;44
štvrtok;25.4.2019;9:00;87;60;27
štvrtok;25.4.2019;10:00;67;35;32
štvrtok;25.4.2019;11:00;74;31;43
štvrtok;25.4.2019;12:00;85;24;61
štvrtok;25.4.2019;13:00;66;39;27
štvrtok;25.4.2019;14:00;113;63;50
štvrtok;25.4.2019;15:00;143;72;71
štvrtok;25.4.2019;16:00;221;122;99
štvrtok;25.4.2019;17:00;287;157;130
štvrtok;25.4.2019;18:00;234;135;99
štvrtok;25.4.2019;19:00;182;79;103
štvrtok;25.4.2019;20:00;83;46;37
štvrtok;25.4.2019;21:00;29;20;9
štvrtok;25.4.2019;22:00;10;9;1
štvrtok;25.4.2019;23:00;6;5;1
piatok;26.4.2019;0:00;11;6;5
piatok;26.4.2019;1:00;3;2;1
piatok;26.4.2019;2:00;0;0;0
piatok;26.4.2019;3:00;1;0;1
piatok;26.4.2019;4:00;1;1;0
piatok;26.4.2019;5:00;11;7;4
piatok;26.4.2019;6:00;27;11;16
piatok;26.4.2019;7:00;85;41;44
piatok;26.4.2019;8:00;96;49;47
piatok;26.4.2019;9:00;91;50;41
piatok;26.4.2019;10:00;58;36;22
piatok;26.4.2019;11:00;64;33;31
piatok;26.4.2019;12:00;59;36;23
piatok;26.4.2019;13:00;75;36;39
piatok;26.4.2019;14:00;89;45;44
piatok;26.4.2019;15:00;156;105;51
piatok;26.4.2019;16:00;174;86;88
piatok;26.4.2019;17:00;202;129;73
piatok;26.4.2019;18:00;171;78;93
piatok;26.4.2019;19:00;123;64;59
piatok;26.4.2019;20:00;81;59;22
piatok;26.4.2019;21:00;34;17;17
piatok;26.4.2019;22:00;15;13;2
piatok;26.4.2019;23:00;5;2;3
sobota;27.4.2019;0:00;8;5;3
sobota;27.4.2019;1:00;3;3;0
sobota;27.4.2019;2:00;3;1;2
sobota;27.4.2019;3:00;0;0;0
sobota;27.4.2019;4:00;1;1;0
sobota;27.4.2019;5:00;2;1;1
sobota;27.4.2019;6:00;3;3;0
sobota;27.4.2019;7:00;8;6;2
sobota;27.4.2019;8:00;60;12;48
sobota;27.4.2019;9:00;33;16;17
sobota;27.4.2019;10:00;158;103;55
sobota;27.4.2019;11:00;60;26;34
sobota;27.4.2019;12:00;78;47;31
sobota;27.4.2019;13:00;116;33;83
sobota;27.4.2019;14:00;90;45;45
sobota;27.4.2019;15:00;89;54;35
sobota;27.4.2019;16:00;88;51;37
sobota;27.4.2019;17:00;91;46;45
sobota;27.4.2019;18:00;72;22;50
sobota;27.4.2019;19:00;52;25;27
sobota;27.4.2019;20:00;24;8;16
sobota;27.4.2019;21:00;16;7;9
sobota;27.4.2019;22:00;16;3;13
sobota;27.4.2019;23:00;12;2;10
nedeľa;28.4.2019;0:00;0;0;0
nedeľa;28.4.2019;1:00;0;0;0
nedeľa;28.4.2019;2:00;3;2;1
nedeľa;28.4.2019;3:00;0;0;0
nedeľa;28.4.2019;4:00;1;1;0
nedeľa;28.4.2019;5:00;2;1;1
nedeľa;28.4.2019;6:00;3;3;0
nedeľa;28.4.2019;7:00;15;10;5
nedeľa;28.4.2019;8:00;27;15;12
nedeľa;28.4.2019;9:00;50;28;22
nedeľa;28.4.2019;10:00;66;32;34
nedeľa;28.4.2019;11:00;102;48;54
nedeľa;28.4.2019;12:00;86;54;32
nedeľa;28.4.2019;13:00;76;32;44
nedeľa;28.4.2019;14:00;90;44;46
nedeľa;28.4.2019;15:00;100;56;44
nedeľa;28.4.2019;16:00;113;59;54
nedeľa;28.4.2019;17:00;114;52;62
nedeľa;28.4.2019;18:00;112;53;59
nedeľa;28.4.2019;19:00;34;19;15
nedeľa;28.4.2019;20:00;21;11;10
nedeľa;28.4.2019;21:00;8;5;3
nedeľa;28.4.2019;22:00;5;2;3
nedeľa;28.4.2019;23:00;0;0;0
pondelok;29.4.2019;0:00;0;0;0
pondelok;29.4.2019;1:00;2;1;1
pondelok;29.4.2019;2:00;0;0;0
pondelok;29.4.2019;3:00;0;0;0
pondelok;29.4.2019;4:00;0;0;0
pondelok;29.4.2019;5:00;4;2;2
pondelok;29.4.2019;6:00;2;2;0
pondelok;29.4.2019;7:00;7;5;2
pondelok;29.4.2019;8:00;27;10;17
pondelok;29.4.2019;9:00;15;4;11
pondelok;29.4.2019;10:00;9;5;4
pondelok;29.4.2019;11:00;4;3;1
pondelok;29.4.2019;12:00;9;2;7
pondelok;29.4.2019;13:00;16;4;12
pondelok;29.4.2019;14:00;10;4;6
pondelok;29.4.2019;15:00;15;4;11
pondelok;29.4.2019;16:00;20;11;9
pondelok;29.4.2019;17:00;24;10;14
pondelok;29.4.2019;18:00;24;14;10
pondelok;29.4.2019;19:00;13;4;9
pondelok;29.4.2019;20:00;8;2;6
pondelok;29.4.2019;21:00;7;3;4
pondelok;29.4.2019;22:00;3;2;1
pondelok;29.4.2019;23:00;0;0;0
utorok;30.4.2019;0:00;0;0;0
utorok;30.4.2019;1:00;0;0;0
utorok;30.4.2019;2:00;0;0;0
utorok;30.4.2019;3:00;0;0;0
utorok;30.4.2019;4:00;0;0;0
utorok;30.4.2019;5:00;2;1;1
utorok;30.4.2019;6:00;9;5;4
utorok;30.4.2019;7:00;13;5;8
utorok;30.4.2019;8:00;22;6;16
utorok;30.4.2019;9:00;21;6;15
utorok;30.4.2019;10:00;22;11;11
utorok;30.4.2019;11:00;19;0;19
utorok;30.4.2019;12:00;9;0;9
utorok;30.4.2019;13:00;10;3;7
utorok;30.4.2019;14:00;10;2;8
utorok;30.4.2019;15:00;25;7;18
utorok;30.4.2019;16:00;37;17;20
utorok;30.4.2019;17:00;41;22;19
utorok;30.4.2019;18:00;17;9;8
utorok;30.4.2019;19:00;24;16;8
utorok;30.4.2019;20:00;11;4;7
utorok;30.4.2019;21:00;1;0;1
utorok;30.4.2019;22:00;1;0;1
utorok;30.4.2019;23:00;2;1;1
streda;1.5.2019;0:00;1;0;1
streda;1.5.2019;1:00;2;0;2
streda;1.5.2019;2:00;0;0;0
streda;1.5.2019;3:00;0;0;0
streda;1.5.2019;4:00;0;0;0
streda;1.5.2019;5:00;2;1;1
streda;1.5.2019;6:00;11;9;2
streda;1.5.2019;7:00;27;18;9
streda;1.5.2019;8:00;38;27;11
streda;1.5.2019;9:00;84;56;28
streda;1.5.2019;10:00;215;156;59
streda;1.5.2019;11:00;291;154;137
streda;1.5.2019;12:00;243;127;116
streda;1.5.2019;13:00;276;144;132
streda;1.5.2019;14:00;386;194;192
streda;1.5.2019;15:00;351;187;164
streda;1.5.2019;16:00;384;175;209
streda;1.5.2019;17:00;225;100;125
streda;1.5.2019;18:00;172;59;113
streda;1.5.2019;19:00;76;37;39
streda;1.5.2019;20:00;17;8;9
streda;1.5.2019;21:00;14;8;6
streda;1.5.2019;22:00;3;2;1
streda;1.5.2019;23:00;4;2;2
štvrtok;2.5.2019;0:00;2;2;0
štvrtok;2.5.2019;1:00;0;0;0
štvrtok;2.5.2019;2:00;0;0;0
štvrtok;2.5.2019;3:00;0;0;0
štvrtok;2.5.2019;4:00;0;0;0
štvrtok;2.5.2019;5:00;13;6;7
štvrtok;2.5.2019;6:00;48;15;33
štvrtok;2.5.2019;7:00;71;40;31
štvrtok;2.5.2019;8:00;94;39;55
štvrtok;2.5.2019;9:00;49;27;22
štvrtok;2.5.2019;10:00;51;32;19
štvrtok;2.5.2019;11:00;67;31;36
štvrtok;2.5.2019;12:00;68;29;39
štvrtok;2.5.2019;13:00;75;39;36
štvrtok;2.5.2019;14:00;103;48;55
štvrtok;2.5.2019;15:00;123;68;55
štvrtok;2.5.2019;16:00;201;117;84
štvrtok;2.5.2019;17:00;254;148;106
štvrtok;2.5.2019;18:00;213;116;97
štvrtok;2.5.2019;19:00;157;73;84
štvrtok;2.5.2019;20:00;68;33;35
štvrtok;2.5.2019;21:00;20;9;11
štvrtok;2.5.2019;22:00;13;3;10
štvrtok;2.5.2019;23:00;3;2;1
piatok;3.5.2019;0:00;1;1;0
piatok;3.5.2019;1:00;1;1;0
piatok;3.5.2019;2:00;1;0;1
piatok;3.5.2019;3:00;0;0;0
piatok;3.5.2019;4:00;0;0;0
piatok;3.5.2019;5:00;5;2;3
piatok;3.5.2019;6:00;15;7;8
piatok;3.5.2019;7:00;33;19;14
piatok;3.5.2019;8:00;33;13;20
piatok;3.5.2019;9:00;19;10;9
piatok;3.5.2019;10:00;11;1;10
piatok;3.5.2019;11:00;12;7;5
piatok;3.5.2019;12:00;12;5;7
piatok;3.5.2019;13:00;19;8;11
piatok;3.5.2019;14:00;32;14;18
piatok;3.5.2019;15:00;52;24;28
piatok;3.5.2019;16:00;87;39;48
piatok;3.5.2019;17:00;84;47;37
piatok;3.5.2019;18:00;95;45;50
piatok;3.5.2019;19:00;41;23;18
piatok;3.5.2019;20:00;37;19;18
piatok;3.5.2019;21:00;16;8;8
piatok;3.5.2019;22:00;9;7;2
piatok;3.5.2019;23:00;3;1;2
sobota;4.5.2019;0:00;1;1;0
sobota;4.5.2019;1:00;1;0;1
sobota;4.5.2019;2:00;0;0;0
sobota;4.5.2019;3:00;0;0;0
sobota;4.5.2019;4:00;0;0;0
sobota;4.5.2019;5:00;0;0;0
sobota;4.5.2019;6:00;4;4;0
sobota;4.5.2019;7:00;11;6;5
sobota;4.5.2019;8:00;16;9;7
sobota;4.5.2019;9:00;28;17;11
sobota;4.5.2019;10:00;26;11;15
sobota;4.5.2019;11:00;36;17;19
sobota;4.5.2019;12:00;45;27;18
sobota;4.5.2019;13:00;63;38;25
sobota;4.5.2019;14:00;75;45;30
sobota;4.5.2019;15:00;107;47;60
sobota;4.5.2019;16:00;75;41;34
sobota;4.5.2019;17:00;64;30;34
sobota;4.5.2019;18:00;68;29;39
sobota;4.5.2019;19:00;41;22;19
sobota;4.5.2019;20:00;36;18;18
sobota;4.5.2019;21:00;15;8;7
sobota;4.5.2019;22:00;9;4;5
sobota;4.5.2019;23:00;2;1;1
nedeľa;5.5.2019;0:00;0;0;0
nedeľa;5.5.2019;1:00;0;0;0
nedeľa;5.5.2019;2:00;3;0;3
nedeľa;5.5.2019;3:00;3;2;1
nedeľa;5.5.2019;4:00;0;0;0
nedeľa;5.5.2019;5:00;0;0;0
nedeľa;5.5.2019;6:00;0;0;0
nedeľa;5.5.2019;7:00;1;1;0
nedeľa;5.5.2019;8:00;1;0;1
nedeľa;5.5.2019;9:00;17;0;17
nedeľa;5.5.2019;10:00;3;2;1
nedeľa;5.5.2019;11:00;2;0;2
nedeľa;5.5.2019;12:00;12;3;9
nedeľa;5.5.2019;13:00;4;0;4
nedeľa;5.5.2019;14:00;4;0;4
nedeľa;5.5.2019;15:00;2;0;2
nedeľa;5.5.2019;16:00;4;1;3
nedeľa;5.5.2019;17:00;13;0;13
nedeľa;5.5.2019;18:00;10;0;10
nedeľa;5.5.2019;19:00;3;1;2
nedeľa;5.5.2019;20:00;9;1;8
nedeľa;5.5.2019;21:00;4;1;3
nedeľa;5.5.2019;22:00;1;0;1
nedeľa;5.5.2019;23:00;5;1;4
pondelok;6.5.2019;0:00;2;0;2
pondelok;6.5.2019;1:00;0;0;0
pondelok;6.5.2019;2:00;0;0;0
pondelok;6.5.2019;3:00;0;0;0
pondelok;6.5.2019;4:00;0;0;0
pondelok;6.5.2019;5:00;4;1;3
pondelok;6.5.2019;6:00;3;1;2
pondelok;6.5.2019;7:00;21;9;12
pondelok;6.5.2019;8:00;30;13;17
pondelok;6.5.2019;9:00;43;30;13
pondelok;6.5.2019;10:00;17;4;13
pondelok;6.5.2019;11:00;7;3;4
pondelok;6.5.2019;12:00;5;3;2
pondelok;6.5.2019;13:00;13;2;11
pondelok;6.5.2019;14:00;10;3;7
pondelok;6.5.2019;15:00;20;10;10
pondelok;6.5.2019;16:00;23;13;10
pondelok;6.5.2019;17:00;53;31;22
pondelok;6.5.2019;18:00;38;22;16
pondelok;6.5.2019;19:00;20;9;11
pondelok;6.5.2019;20:00;9;7;2
pondelok;6.5.2019;21:00;6;4;2
pondelok;6.5.2019;22:00;1;1;0
pondelok;6.5.2019;23:00;1;0;1
utorok;7.5.2019;0:00;0;0;0
utorok;7.5.2019;1:00;0;0;0
utorok;7.5.2019;2:00;0;0;0
utorok;7.5.2019;3:00;0;0;0
utorok;7.5.2019;4:00;0;0;0
utorok;7.5.2019;5:00;7;1;6
utorok;7.5.2019;6:00;29;19;10
utorok;7.5.2019;7:00;54;25;29
utorok;7.5.2019;8:00;68;34;34
utorok;7.5.2019;9:00;48;20;28
utorok;7.5.2019;10:00;40;18;22
utorok;7.5.2019;11:00;20;10;10
utorok;7.5.2019;12:00;19;9;10
utorok;7.5.2019;13:00;23;10;13
utorok;7.5.2019;14:00;32;15;17
utorok;7.5.2019;15:00;46;27;19
utorok;7.5.2019;16:00;128;66;62
utorok;7.5.2019;17:00;184;102;82
utorok;7.5.2019;18:00;100;53;47
utorok;7.5.2019;19:00;98;37;61
utorok;7.5.2019;20:00;30;19;11
utorok;7.5.2019;21:00;11;6;5
utorok;7.5.2019;22:00;5;4;1
utorok;7.5.2019;23:00;8;4;4
streda;8.5.2019;0:00;0;0;0
streda;8.5.2019;1:00;1;0;1
streda;8.5.2019;2:00;0;0;0
streda;8.5.2019;3:00;0;0;0
streda;8.5.2019;4:00;1;0;1
streda;8.5.2019;5:00;1;1;0
streda;8.5.2019;6:00;10;7;3
streda;8.5.2019;7:00;26;23;3
streda;8.5.2019;8:00;34;27;7
streda;8.5.2019;9:00;136;76;60
streda;8.5.2019;10:00;182;130;52
streda;8.5.2019;11:00;262;163;99
streda;8.5.2019;12:00;245;146;99
streda;8.5.2019;13:00;262;153;109
streda;8.5.2019;14:00;345;210;135
streda;8.5.2019;15:00;278;150;128
streda;8.5.2019;16:00;267;137;130
streda;8.5.2019;17:00;240;99;141
streda;8.5.2019;18:00;116;40;76
streda;8.5.2019;19:00;78;32;46
streda;8.5.2019;20:00;34;12;22
streda;8.5.2019;21:00;8;7;1
streda;8.5.2019;22:00;16;11;5
streda;8.5.2019;23:00;2;2;0
štvrtok;9.5.2019;0:00;1;1;0
štvrtok;9.5.2019;1:00;3;2;1
štvrtok;9.5.2019;2:00;0;0;0
štvrtok;9.5.2019;3:00;0;0;0
štvrtok;9.5.2019;4:00;0;0;0
štvrtok;9.5.2019;5:00;5;1;4
štvrtok;9.5.2019;6:00;15;8;7
štvrtok;9.5.2019;7:00;38;15;23
štvrtok;9.5.2019;8:00;40;17;23
štvrtok;9.5.2019;9:00;11;5;6
štvrtok;9.5.2019;10:00;6;3;3
štvrtok;9.5.2019;11:00;12;1;11
štvrtok;9.5.2019;12:00;6;0;6
štvrtok;9.5.2019;13:00;21;4;17
štvrtok;9.5.2019;14:00;5;0;5
štvrtok;9.5.2019;15:00;19;11;8
štvrtok;9.5.2019;16:00;50;26;24
štvrtok;9.5.2019;17:00;78;49;29
štvrtok;9.5.2019;18:00;62;29;33
štvrtok;9.5.2019;19:00;62;39;23
štvrtok;9.5.2019;20:00;24;9;15
štvrtok;9.5.2019;21:00;4;2;2
štvrtok;9.5.2019;22:00;5;5;0
štvrtok;9.5.2019;23:00;1;0;1
piatok;10.5.2019;0:00;0;0;0
piatok;10.5.2019;1:00;0;0;0
piatok;10.5.2019;2:00;1;1;0
piatok;10.5.2019;3:00;0;0;0
piatok;10.5.2019;4:00;1;0;1
piatok;10.5.2019;5:00;10;5;5
piatok;10.5.2019;6:00;27;14;13
piatok;10.5.2019;7:00;44;23;21
piatok;10.5.2019;8:00;65;28;37
piatok;10.5.2019;9:00;36;19;17
piatok;10.5.2019;10:00;53;29;24
piatok;10.5.2019;11:00;33;16;17
piatok;10.5.2019;12:00;33;17;16
piatok;10.5.2019;13:00;42;22;20
piatok;10.5.2019;14:00;66;30;36
piatok;10.5.2019;15:00;61;29;32
piatok;10.5.2019;16:00;122;69;53
piatok;10.5.2019;17:00;116;71;45
piatok;10.5.2019;18:00;106;56;50
piatok;10.5.2019;19:00;88;45;43
piatok;10.5.2019;20:00;32;12;20
piatok;10.5.2019;21:00;6;4;2
piatok;10.5.2019;22:00;5;2;3
piatok;10.5.2019;23:00;5;3;2
sobota;11.5.2019;0:00;1;0;1
sobota;11.5.2019;1:00;0;0;0
sobota;11.5.2019;2:00;2;2;0
sobota;11.5.2019;3:00;0;0;0
sobota;11.5.2019;4:00;0;0;0
sobota;11.5.2019;5:00;3;2;1
sobota;11.5.2019;6:00;8;5;3
sobota;11.5.2019;7:00;18;14;4
sobota;11.5.2019;8:00;38;18;20
sobota;11.5.2019;9:00;98;62;36
sobota;11.5.2019;10:00;129;95;34
sobota;11.5.2019;11:00;149;95;54
sobota;11.5.2019;12:00;169;102;67
sobota;11.5.2019;13:00;213;134;79
sobota;11.5.2019;14:00;240;128;112
sobota;11.5.2019;15:00;197;100;97
sobota;11.5.2019;16:00;200;90;110
sobota;11.5.2019;17:00;98;38;60
sobota;11.5.2019;18:00;34;13;21
sobota;11.5.2019;19:00;29;12;17
sobota;11.5.2019;20:00;16;11;5
sobota;11.5.2019;21:00;5;4;1
sobota;11.5.2019;22:00;1;1;0
sobota;11.5.2019;23:00;0;0;0
nedeľa;12.5.2019;0:00;1;0;1
nedeľa;12.5.2019;1:00;0;0;0
nedeľa;12.5.2019;2:00;0;0;0
nedeľa;12.5.2019;3:00;0;0;0
nedeľa;12.5.2019;4:00;0;0;0
nedeľa;12.5.2019;5:00;1;1;0
nedeľa;12.5.2019;6:00;5;4;1
nedeľa;12.5.2019;7:00;9;6;3
nedeľa;12.5.2019;8:00;8;2;6
nedeľa;12.5.2019;9:00;19;9;10
nedeľa;12.5.2019;10:00;21;16;5
nedeľa;12.5.2019;11:00;68;38;30
nedeľa;12.5.2019;12:00;18;7;11
nedeľa;12.5.2019;13:00;21;11;10
nedeľa;12.5.2019;14:00;36;9;27
nedeľa;12.5.2019;15:00;22;11;11
nedeľa;12.5.2019;16:00;23;15;8
nedeľa;12.5.2019;17:00;20;9;11
nedeľa;12.5.2019;18:00;13;9;4
nedeľa;12.5.2019;19:00;10;5;5
nedeľa;12.5.2019;20:00;7;1;6
nedeľa;12.5.2019;21:00;2;1;1
nedeľa;12.5.2019;22:00;0;0;0
nedeľa;12.5.2019;23:00;0;0;0
pondelok;13.5.2019;0:00;1;0;1
pondelok;13.5.2019;1:00;3;1;2
pondelok;13.5.2019;2:00;0;0;0
pondelok;13.5.2019;3:00;0;0;0
pondelok;13.5.2019;4:00;2;0;2
pondelok;13.5.2019;5:00;1;1;0
pondelok;13.5.2019;6:00;8;4;4
pondelok;13.5.2019;7:00;13;5;8
pondelok;13.5.2019;8:00;31;18;13
pondelok;13.5.2019;9:00;29;6;23
pondelok;13.5.2019;10:00;12;3;9
pondelok;13.5.2019;11:00;5;3;2
pondelok;13.5.2019;12:00;6;1;5
pondelok;13.5.2019;13:00;11;6;5
pondelok;13.5.2019;14:00;8;5;3
pondelok;13.5.2019;15:00;21;15;6
pondelok;13.5.2019;16:00;31;11;20
pondelok;13.5.2019;17:00;52;24;28
pondelok;13.5.2019;18:00;45;20;25
pondelok;13.5.2019;19:00;12;4;8
pondelok;13.5.2019;20:00;7;6;1
pondelok;13.5.2019;21:00;4;2;2
pondelok;13.5.2019;22:00;2;1;1
pondelok;13.5.2019;23:00;1;1;0
utorok;14.5.2019;0:00;0;0;0
utorok;14.5.2019;1:00;1;1;0
utorok;14.5.2019;2:00;0;0;0
utorok;14.5.2019;3:00;0;0;0
utorok;14.5.2019;4:00;0;0;0
utorok;14.5.2019;5:00;7;1;6
utorok;14.5.2019;6:00;5;0;5
utorok;14.5.2019;7:00;23;8;15
utorok;14.5.2019;8:00;38;22;16
utorok;14.5.2019;9:00;16;6;10
utorok;14.5.2019;10:00;21;14;7
utorok;14.5.2019;11:00;17;5;12
utorok;14.5.2019;12:00;8;6;2
utorok;14.5.2019;13:00;19;10;9
utorok;14.5.2019;14:00;6;1;5
utorok;14.5.2019;15:00;27;14;13
utorok;14.5.2019;16:00;26;17;9
utorok;14.5.2019;17:00;39;22;17
utorok;14.5.2019;18:00;14;4;10
utorok;14.5.2019;19:00;5;4;1
utorok;14.5.2019;20:00;2;2;0
utorok;14.5.2019;21:00;4;1;3
utorok;14.5.2019;22:00;3;1;2
utorok;14.5.2019;23:00;0;0;0
streda;15.5.2019;0:00;0;0;0
streda;15.5.2019;1:00;0;0;0
streda;15.5.2019;2:00;0;0;0
streda;15.5.2019;3:00;0;0;0
streda;15.5.2019;4:00;0;0;0
streda;15.5.2019;5:00;6;2;4
streda;15.5.2019;6:00;9;6;3
streda;15.5.2019;7:00;31;10;21
streda;15.5.2019;8:00;25;12;13
streda;15.5.2019;9:00;23;5;18
streda;15.5.2019;10:00;16;9;7
streda;15.5.2019;11:00;4;2;2
streda;15.5.2019;12:00;11;5;6
streda;15.5.2019;13:00;8;3;5
streda;15.5.2019;14:00;11;8;3
streda;15.5.2019;15:00;21;9;12
streda;15.5.2019;16:00;14;8;6
streda;15.5.2019;17:00;19;12;7
streda;15.5.2019;18:00;5;2;3
streda;15.5.2019;19:00;8;5;3
streda;15.5.2019;20:00;2;0;2
streda;15.5.2019;21:00;1;0;1
streda;15.5.2019;22:00;4;2;2
streda;15.5.2019;23:00;0;0;0
štvrtok;16.5.2019;0:00;0;0;0
štvrtok;16.5.2019;1:00;0;0;0
štvrtok;16.5.2019;2:00;0;0;0
štvrtok;16.5.2019;3:00;0;0;0
štvrtok;16.5.2019;4:00;0;0;0
štvrtok;16.5.2019;5:00;5;3;2
štvrtok;16.5.2019;6:00;6;5;1
štvrtok;16.5.2019;7:00;14;5;9
štvrtok;16.5.2019;8:00;26;12;14
štvrtok;16.5.2019;9:00;13;6;7
štvrtok;16.5.2019;10:00;8;5;3
štvrtok;16.5.2019;11:00;7;2;5
štvrtok;16.5.2019;12:00;3;1;2
štvrtok;16.5.2019;13:00;10;6;4
štvrtok;16.5.2019;14:00;13;9;4
štvrtok;16.5.2019;15:00;25;14;11
štvrtok;16.5.2019;16:00;61;36;25
štvrtok;16.5.2019;17:00;81;49;32
štvrtok;16.5.2019;18:00;62;28;34
štvrtok;16.5.2019;19:00;44;20;24
štvrtok;16.5.2019;20:00;23;13;10
štvrtok;16.5.2019;21:00;10;8;2
štvrtok;16.5.2019;22:00;4;3;1
štvrtok;16.5.2019;23:00;0;0;0
piatok;17.5.2019;0:00;1;1;0
piatok;17.5.2019;1:00;0;0;0
piatok;17.5.2019;2:00;0;0;0
piatok;17.5.2019;3:00;0;0;0
piatok;17.5.2019;4:00;0;0;0
piatok;17.5.2019;5:00;6;5;1
piatok;17.5.2019;6:00;30;15;15
piatok;17.5.2019;7:00;60;24;36
piatok;17.5.2019;8:00;78;48;30
piatok;17.5.2019;9:00;46;15;31
piatok;17.5.2019;10:00;45;18;27
piatok;17.5.2019;11:00;41;30;11
piatok;17.5.2019;12:00;32;16;16
piatok;17.5.2019;13:00;52;31;21
piatok;17.5.2019;14:00;58;31;27
piatok;17.5.2019;15:00;79;51;28
piatok;17.5.2019;16:00;105;61;44
piatok;17.5.2019;17:00;104;57;47
piatok;17.5.2019;18:00;60;31;29
piatok;17.5.2019;19:00;53;29;24
piatok;17.5.2019;20:00;20;6;14
piatok;17.5.2019;21:00;11;0;11
piatok;17.5.2019;22:00;5;3;2
piatok;17.5.2019;23:00;1;1;0
sobota;18.5.2019;0:00;5;4;1
sobota;18.5.2019;1:00;1;1;0
sobota;18.5.2019;2:00;0;0;0
sobota;18.5.2019;3:00;2;0;2
sobota;18.5.2019;4:00;5;2;3
sobota;18.5.2019;5:00;2;0;2
sobota;18.5.2019;6:00;7;4;3
sobota;18.5.2019;7:00;22;17;5
sobota;18.5.2019;8:00;35;17;18
sobota;18.5.2019;9:00;85;57;28
sobota;18.5.2019;10:00;184;122;62
sobota;18.5.2019;11:00;203;118;85
sobota;18.5.2019;12:00;163;88;75
sobota;18.5.2019;13:00;220;127;93
sobota;18.5.2019;14:00;246;137;109
sobota;18.5.2019;15:00;265;132;133
sobota;18.5.2019;16:00;301;164;137
sobota;18.5.2019;17:00;237;110;127
sobota;18.5.2019;18:00;171;69;102
sobota;18.5.2019;19:00;128;52;76
sobota;18.5.2019;20:00;58;24;34
sobota;18.5.2019;21:00;21;10;11
sobota;18.5.2019;22:00;4;4;0
sobota;18.5.2019;23:00;2;2;0
nedeľa;19.5.2019;0:00;2;1;1
nedeľa;19.5.2019;1:00;0;0;0
nedeľa;19.5.2019;2:00;1;0;1
nedeľa;19.5.2019;3:00;0;0;0
nedeľa;19.5.2019;4:00;1;0;1
nedeľa;19.5.2019;5:00;3;2;1
nedeľa;19.5.2019;6:00;5;4;1
nedeľa;19.5.2019;7:00;12;11;1
nedeľa;19.5.2019;8:00;32;16;16
nedeľa;19.5.2019;9:00;84;53;31
nedeľa;19.5.2019;10:00;162;82;80
nedeľa;19.5.2019;11:00;175;102;73
nedeľa;19.5.2019;12:00;166;84;82
nedeľa;19.5.2019;13:00;199;110;89
nedeľa;19.5.2019;14:00;224;128;96
nedeľa;19.5.2019;15:00;193;96;97
nedeľa;19.5.2019;16:00;156;78;78
nedeľa;19.5.2019;17:00;84;46;38
nedeľa;19.5.2019;18:00;76;32;44
nedeľa;19.5.2019;19:00;65;28;37
nedeľa;19.5.2019;20:00;27;15;12
nedeľa;19.5.2019;21:00;4;2;2
nedeľa;19.5.2019;22:00;4;2;2
nedeľa;19.5.2019;23:00;5;5;0
pondelok;20.5.2019;0:00;0;0;0
pondelok;20.5.2019;1:00;1;1;0
pondelok;20.5.2019;2:00;0;0;0
pondelok;20.5.2019;3:00;0;0;0
pondelok;20.5.2019;4:00;0;0;0
pondelok;20.5.2019;5:00;2;2;0
pondelok;20.5.2019;6:00;7;3;4
pondelok;20.5.2019;7:00;6;2;4
pondelok;20.5.2019;8:00;9;4;5
pondelok;20.5.2019;9:00;15;5;10
pondelok;20.5.2019;10:00;9;3;6
pondelok;20.5.2019;11:00;19;5;14
pondelok;20.5.2019;12:00;14;11;3
pondelok;20.5.2019;13:00;11;6;5
pondelok;20.5.2019;14:00;20;11;9
pondelok;20.5.2019;15:00;23;12;11
pondelok;20.5.2019;16:00;30;12;18
pondelok;20.5.2019;17:00;61;36;25
pondelok;20.5.2019;18:00;57;27;30
pondelok;20.5.2019;19:00;58;26;32
pondelok;20.5.2019;20:00;36;17;19
pondelok;20.5.2019;21:00;18;11;7
pondelok;20.5.2019;22:00;5;4;1
pondelok;20.5.2019;23:00;0;0;0
utorok;21.5.2019;0:00;3;3;0
utorok;21.5.2019;1:00;0;0;0
utorok;21.5.2019;2:00;0;0;0
utorok;21.5.2019;3:00;0;0;0
utorok;21.5.2019;4:00;1;1;0
utorok;21.5.2019;5:00;7;4;3
utorok;21.5.2019;6:00;44;30;14
utorok;21.5.2019;7:00;84;41;43
utorok;21.5.2019;8:00;86;35;51
utorok;21.5.2019;9:00;69;30;39
utorok;21.5.2019;10:00;74;45;29
utorok;21.5.2019;11:00;75;35;40
utorok;21.5.2019;12:00;54;26;28
utorok;21.5.2019;13:00;23;13;10
utorok;21.5.2019;14:00;33;15;18
utorok;21.5.2019;15:00;72;39;33
utorok;21.5.2019;16:00;96;57;39
utorok;21.5.2019;17:00;147;82;65
utorok;21.5.2019;18:00;92;49;43
utorok;21.5.2019;19:00;57;20;37
utorok;21.5.2019;20:00;26;13;13
utorok;21.5.2019;21:00;8;6;2
utorok;21.5.2019;22:00;7;2;5
utorok;21.5.2019;23:00;0;0;0
streda;22.5.2019;0:00;0;0;0
streda;22.5.2019;1:00;0;0;0
streda;22.5.2019;2:00;1;0;1
streda;22.5.2019;3:00;0;0;0
streda;22.5.2019;4:00;1;1;0
streda;22.5.2019;5:00;2;1;1
streda;22.5.2019;6:00;7;5;2
streda;22.5.2019;7:00;9;5;4
streda;22.5.2019;8:00;11;2;9
streda;22.5.2019;9:00;18;5;13
streda;22.5.2019;10:00;10;4;6
streda;22.5.2019;11:00;1;0;1
streda;22.5.2019;12:00;4;1;3
streda;22.5.2019;13:00;0;0;0
streda;22.5.2019;14:00;2;0;2
streda;22.5.2019;15:00;19;3;16
streda;22.5.2019;16:00;13;7;6
streda;22.5.2019;17:00;8;5;3
streda;22.5.2019;18:00;4;2;2
streda;22.5.2019;19:00;7;3;4
streda;22.5.2019;20:00;2;1;1
streda;22.5.2019;21:00;0;0;0
streda;22.5.2019;22:00;1;0;1
streda;22.5.2019;23:00;11;0;11
štvrtok;23.5.2019;0:00;0;0;0
štvrtok;23.5.2019;1:00;0;0;0
štvrtok;23.5.2019;2:00;0;0;0
štvrtok;23.5.2019;3:00;0;0;0
štvrtok;23.5.2019;4:00;1;0;1
štvrtok;23.5.2019;5:00;5;4;1
štvrtok;23.5.2019;6:00;17;8;9
štvrtok;23.5.2019;7:00;27;8;19
štvrtok;23.5.2019;8:00;43;22;21
štvrtok;23.5.2019;9:00;22;7;15
štvrtok;23.5.2019;10:00;8;7;1
štvrtok;23.5.2019;11:00;20;7;13
štvrtok;23.5.2019;12:00;24;5;19
štvrtok;23.5.2019;13:00;34;9;25
štvrtok;23.5.2019;14:00;82;23;59
štvrtok;23.5.2019;15:00;57;31;26
štvrtok;23.5.2019;16:00;76;42;34
štvrtok;23.5.2019;17:00;58;34;24
štvrtok;23.5.2019;18:00;26;13;13
štvrtok;23.5.2019;19:00;45;19;26
štvrtok;23.5.2019;20:00;28;14;14
štvrtok;23.5.2019;21:00;9;4;5
štvrtok;23.5.2019;22:00;0;0;0
štvrtok;23.5.2019;23:00;5;5;0
piatok;24.5.2019;0:00;2;2;0
piatok;24.5.2019;1:00;0;0;0
piatok;24.5.2019;2:00;0;0;0
piatok;24.5.2019;3:00;0;0;0
piatok;24.5.2019;4:00;0;0;0
piatok;24.5.2019;5:00;15;10;5
piatok;24.5.2019;6:00;47;30;17
piatok;24.5.2019;7:00;87;33;54
piatok;24.5.2019;8:00;97;53;44
piatok;24.5.2019;9:00;69;37;32
piatok;24.5.2019;10:00;60;32;28
piatok;24.5.2019;11:00;55;28;27
piatok;24.5.2019;12:00;68;35;33
piatok;24.5.2019;13:00;85;37;48
piatok;24.5.2019;14:00;117;59;58
piatok;24.5.2019;15:00;165;82;83
piatok;24.5.2019;16:00;221;130;91
piatok;24.5.2019;17:00;270;155;115
piatok;24.5.2019;18:00;222;109;113
piatok;24.5.2019;19:00;171;104;67
piatok;24.5.2019;20:00;74;30;44
piatok;24.5.2019;21:00;28;14;14
piatok;24.5.2019;22:00;15;10;5
piatok;24.5.2019;23:00;12;10;2
sobota;25.5.2019;0:00;4;3;1
sobota;25.5.2019;1:00;2;0;2
sobota;25.5.2019;2:00;1;0;1
sobota;25.5.2019;3:00;0;0;0
sobota;25.5.2019;4:00;0;0;0
sobota;25.5.2019;5:00;3;1;2
sobota;25.5.2019;6:00;9;6;3
sobota;25.5.2019;7:00;25;16;9
sobota;25.5.2019;8:00;66;44;22
sobota;25.5.2019;9:00;191;145;46
sobota;25.5.2019;10:00;234;144;90
sobota;25.5.2019;11:00;290;176;114
sobota;25.5.2019;12:00;260;156;104
sobota;25.5.2019;13:00;278;148;130
sobota;25.5.2019;14:00;303;169;134
sobota;25.5.2019;15:00;359;184;175
sobota;25.5.2019;16:00;341;187;154
sobota;25.5.2019;17:00;311;149;162
sobota;25.5.2019;18:00;252;90;162
sobota;25.5.2019;19:00;150;70;80
sobota;25.5.2019;20:00;79;40;39
sobota;25.5.2019;21:00;26;10;16
sobota;25.5.2019;22:00;9;6;3
sobota;25.5.2019;23:00;3;1;2
nedeľa;26.5.2019;0:00;14;10;4
nedeľa;26.5.2019;1:00;2;1;1
nedeľa;26.5.2019;2:00;1;1;0
nedeľa;26.5.2019;3:00;0;0;0
nedeľa;26.5.2019;4:00;2;2;0
nedeľa;26.5.2019;5:00;0;0;0
nedeľa;26.5.2019;6:00;6;5;1
nedeľa;26.5.2019;7:00;13;9;4
nedeľa;26.5.2019;8:00;46;28;18
nedeľa;26.5.2019;9:00;106;58;48
nedeľa;26.5.2019;10:00;204;112;92
nedeľa;26.5.2019;11:00;253;130;123
nedeľa;26.5.2019;12:00;217;114;103
nedeľa;26.5.2019;13:00;266;160;106
nedeľa;26.5.2019;14:00;358;178;180
nedeľa;26.5.2019;15:00;375;199;176
nedeľa;26.5.2019;16:00;376;199;177
nedeľa;26.5.2019;17:00;310;167;143
nedeľa;26.5.2019;18:00;211;112;99
nedeľa;26.5.2019;19:00;124;65;59
nedeľa;26.5.2019;20:00;49;30;19
nedeľa;26.5.2019;21:00;20;12;8
nedeľa;26.5.2019;22:00;8;7;1
nedeľa;26.5.2019;23:00;2;1;1
pondelok;27.5.2019;0:00;3;3;0
pondelok;27.5.2019;1:00;0;0;0
pondelok;27.5.2019;2:00;0;0;0
pondelok;27.5.2019;3:00;0;0;0
pondelok;27.5.2019;4:00;1;1;0
pondelok;27.5.2019;5:00;8;5;3
pondelok;27.5.2019;6:00;34;17;17
pondelok;27.5.2019;7:00;76;43;33
pondelok;27.5.2019;8:00;154;85;69
pondelok;27.5.2019;9:00;69;33;36
pondelok;27.5.2019;10:00;44;18;26
pondelok;27.5.2019;11:00;53;21;32
pondelok;27.5.2019;12:00;50;21;29
pondelok;27.5.2019;13:00;42;25;17
pondelok;27.5.2019;14:00;51;28;23
pondelok;27.5.2019;15:00;80;41;39
pondelok;27.5.2019;16:00;37;21;16
pondelok;27.5.2019;17:00;42;21;21
pondelok;27.5.2019;18:00;18;11;7
pondelok;27.5.2019;19:00;19;8;11
pondelok;27.5.2019;20:00;11;5;6
pondelok;27.5.2019;21:00;7;6;1
pondelok;27.5.2019;22:00;1;1;0
pondelok;27.5.2019;23:00;0;0;0
utorok;28.5.2019;0:00;0;0;0
utorok;28.5.2019;1:00;1;1;0
utorok;28.5.2019;2:00;0;0;0
utorok;28.5.2019;3:00;0;0;0
utorok;28.5.2019;4:00;0;0;0
utorok;28.5.2019;5:00;3;2;1
utorok;28.5.2019;6:00;16;8;8
utorok;28.5.2019;7:00;27;15;12
utorok;28.5.2019;8:00;21;9;12
utorok;28.5.2019;9:00;15;3;12
utorok;28.5.2019;10:00;23;6;17
utorok;28.5.2019;11:00;22;10;12
utorok;28.5.2019;12:00;8;3;5
utorok;28.5.2019;13:00;10;3;7
utorok;28.5.2019;14:00;6;1;5
utorok;28.5.2019;15:00;12;7;5
utorok;28.5.2019;16:00;27;9;18
utorok;28.5.2019;17:00;21;10;11
utorok;28.5.2019;18:00;24;14;10
utorok;28.5.2019;19:00;21;10;11
utorok;28.5.2019;20:00;21;10;11
utorok;28.5.2019;21:00;10;6;4
utorok;28.5.2019;22:00;4;1;3
utorok;28.5.2019;23:00;4;3;1
streda;29.5.2019;0:00;1;0;1
streda;29.5.2019;1:00;0;0;0
streda;29.5.2019;2:00;0;0;0
streda;29.5.2019;3:00;0;0;0
streda;29.5.2019;4:00;2;2;0
streda;29.5.2019;5:00;5;2;3
streda;29.5.2019;6:00;13;8;5
streda;29.5.2019;7:00;31;20;11
streda;29.5.2019;8:00;33;22;11
streda;29.5.2019;9:00;27;4;23
streda;29.5.2019;10:00;26;14;12
streda;29.5.2019;11:00;13;6;7
streda;29.5.2019;12:00;20;8;12
streda;29.5.2019;13:00;13;4;9
streda;29.5.2019;14:00;18;9;9
streda;29.5.2019;15:00;35;25;10
streda;29.5.2019;16:00;51;25;26
streda;29.5.2019;17:00;65;32;33
streda;29.5.2019;18:00;73;37;36
streda;29.5.2019;19:00;27;14;13
streda;29.5.2019;20:00;21;7;14
streda;29.5.2019;21:00;8;3;5
streda;29.5.2019;22:00;5;1;4
streda;29.5.2019;23:00;1;0;1
štvrtok;30.5.2019;0:00;0;0;0
štvrtok;30.5.2019;1:00;1;1;0
štvrtok;30.5.2019;2:00;0;0;0
štvrtok;30.5.2019;3:00;0;0;0
štvrtok;30.5.2019;4:00;0;0;0
štvrtok;30.5.2019;5:00;1;1;0
štvrtok;30.5.2019;6:00;7;5;2
štvrtok;30.5.2019;7:00;3;0;3
štvrtok;30.5.2019;8:00;8;3;5
štvrtok;30.5.2019;9:00;7;5;2
štvrtok;30.5.2019;10:00;5;4;1
štvrtok;30.5.2019;11:00;13;5;8
štvrtok;30.5.2019;12:00;3;1;2
štvrtok;30.5.2019;13:00;9;1;8
štvrtok;30.5.2019;14:00;9;3;6
štvrtok;30.5.2019;15:00;6;3;3
štvrtok;30.5.2019;16:00;14;7;7
štvrtok;30.5.2019;17:00;13;4;9
štvrtok;30.5.2019;18:00;19;5;14
štvrtok;30.5.2019;19:00;16;8;8
štvrtok;30.5.2019;20:00;6;2;4
štvrtok;30.5.2019;21:00;4;3;1
štvrtok;30.5.2019;22:00;4;2;2
štvrtok;30.5.2019;23:00;2;0;2
piatok;31.5.2019;0:00;0;0;0
piatok;31.5.2019;1:00;0;0;0
piatok;31.5.2019;2:00;0;0;0
piatok;31.5.2019;3:00;0;0;0
piatok;31.5.2019;4:00;1;0;1
piatok;31.5.2019;5:00;6;3;3
piatok;31.5.2019;6:00;36;23;13
piatok;31.5.2019;7:00;40;23;17
piatok;31.5.2019;8:00;61;34;27
piatok;31.5.2019;9:00;50;25;25
piatok;31.5.2019;10:00;65;38;27
piatok;31.5.2019;11:00;59;23;36
piatok;31.5.2019;12:00;47;30;17
piatok;31.5.2019;13:00;75;34;41
piatok;31.5.2019;14:00;102;51;51
piatok;31.5.2019;15:00;154;86;68
piatok;31.5.2019;16:00;178;91;87
piatok;31.5.2019;17:00;224;125;99
piatok;31.5.2019;18:00;169;100;69
piatok;31.5.2019;19:00;144;81;63
piatok;31.5.2019;20:00;90;55;35
piatok;31.5.2019;21:00;35;16;19
piatok;31.5.2019;22:00;11;9;2
piatok;31.5.2019;23:00;6;4;2
sobota;1.6.2019;0:00;3;3;0
sobota;1.6.2019;1:00;1;0;1
sobota;1.6.2019;2:00;2;0;2
sobota;1.6.2019;3:00;1;1;0
sobota;1.6.2019;4:00;1;0;1
sobota;1.6.2019;5:00;6;4;2
sobota;1.6.2019;6:00;15;10;5
sobota;1.6.2019;7:00;19;11;8
sobota;1.6.2019;8:00;76;57;19
sobota;1.6.2019;9:00;157;91;66
sobota;1.6.2019;10:00;259;177;82
sobota;1.6.2019;11:00;284;155;129
sobota;1.6.2019;12:00;238;136;102
sobota;1.6.2019;13:00;323;172;151
sobota;1.6.2019;14:00;290;148;142
sobota;1.6.2019;15:00;331;161;170
sobota;1.6.2019;16:00;347;167;180
sobota;1.6.2019;17:00;280;146;134
sobota;1.6.2019;18:00;243;106;137
sobota;1.6.2019;19:00;151;71;80
sobota;1.6.2019;20:00;69;40;29
sobota;1.6.2019;21:00;19;9;10
sobota;1.6.2019;22:00;26;15;11
sobota;1.6.2019;23:00;2;2;0
nedeľa;2.6.2019;0:00;4;2;2
nedeľa;2.6.2019;1:00;4;3;1
nedeľa;2.6.2019;2:00;3;3;0
nedeľa;2.6.2019;3:00;0;0;0
nedeľa;2.6.2019;4:00;1;0;1
nedeľa;2.6.2019;5:00;5;3;2
nedeľa;2.6.2019;6:00;11;8;3
nedeľa;2.6.2019;7:00;31;17;14
nedeľa;2.6.2019;8:00;83;53;30
nedeľa;2.6.2019;9:00;200;113;87
nedeľa;2.6.2019;10:00;245;138;107
nedeľa;2.6.2019;11:00;321;180;141
nedeľa;2.6.2019;12:00;249;140;109
nedeľa;2.6.2019;13:00;266;143;123
nedeľa;2.6.2019;14:00;286;135;151
nedeľa;2.6.2019;15:00;364;189;175
nedeľa;2.6.2019;16:00;347;185;162
nedeľa;2.6.2019;17:00;324;165;159
nedeľa;2.6.2019;18:00;273;145;128
nedeľa;2.6.2019;19:00;158;77;81
nedeľa;2.6.2019;20:00;77;43;34
nedeľa;2.6.2019;21:00;26;12;14
nedeľa;2.6.2019;22:00;6;3;3
nedeľa;2.6.2019;23:00;7;5;2
pondelok;3.6.2019;0:00;0;0;0
pondelok;3.6.2019;1:00;0;0;0
pondelok;3.6.2019;2:00;0;0;0
pondelok;3.6.2019;3:00;0;0;0
pondelok;3.6.2019;4:00;0;0;0
pondelok;3.6.2019;5:00;17;10;7
pondelok;3.6.2019;6:00;41;24;17
pondelok;3.6.2019;7:00;90;40;50
pondelok;3.6.2019;8:00;110;43;67
pondelok;3.6.2019;9:00;97;34;63
pondelok;3.6.2019;10:00;64;32;32
pondelok;3.6.2019;11:00;75;30;45
pondelok;3.6.2019;12:00;56;31;25
pondelok;3.6.2019;13:00;65;29;36
pondelok;3.6.2019;14:00;78;39;39
pondelok;3.6.2019;15:00;133;71;62
pondelok;3.6.2019;16:00;229;126;103
pondelok;3.6.2019;17:00;294;173;121
pondelok;3.6.2019;18:00;298;194;104
pondelok;3.6.2019;19:00;223;115;108
pondelok;3.6.2019;20:00;149;88;61
pondelok;3.6.2019;21:00;45;25;20
pondelok;3.6.2019;22:00;9;7;2
pondelok;3.6.2019;23:00;5;2;3
utorok;4.6.2019;0:00;1;1;0
utorok;4.6.2019;1:00;1;1;0
utorok;4.6.2019;2:00;0;0;0
utorok;4.6.2019;3:00;0;0;0
utorok;4.6.2019;4:00;2;1;1
utorok;4.6.2019;5:00;21;12;9
utorok;4.6.2019;6:00;77;47;30
utorok;4.6.2019;7:00;111;50;61
utorok;4.6.2019;8:00;146;73;73
utorok;4.6.2019;9:00;81;42;39
utorok;4.6.2019;10:00;88;51;37
utorok;4.6.2019;11:00;83;37;46
utorok;4.6.2019;12:00;66;28;38
utorok;4.6.2019;13:00;63;32;31
utorok;4.6.2019;14:00;100;57;43
utorok;4.6.2019;15:00;129;69;60
utorok;4.6.2019;16:00;225;120;105
utorok;4.6.2019;17:00;320;184;136
utorok;4.6.2019;18:00;249;151;98
utorok;4.6.2019;19:00;197;96;101
utorok;4.6.2019;20:00;112;57;55
utorok;4.6.2019;21:00;58;34;24
utorok;4.6.2019;22:00;19;12;7
utorok;4.6.2019;23:00;11;5;6
streda;5.6.2019;0:00;3;2;1
streda;5.6.2019;1:00;0;0;0
streda;5.6.2019;2:00;0;0;0
streda;5.6.2019;3:00;0;0;0
streda;5.6.2019;4:00;4;2;2
streda;5.6.2019;5:00;18;8;10
streda;5.6.2019;6:00;52;23;29
streda;5.6.2019;7:00;93;47;46
streda;5.6.2019;8:00;115;49;66
streda;5.6.2019;9:00;91;54;37
streda;5.6.2019;10:00;51;28;23
streda;5.6.2019;11:00;90;35;55
streda;5.6.2019;12:00;64;25;39
streda;5.6.2019;13:00;61;34;27
streda;5.6.2019;14:00;74;41;33
streda;5.6.2019;15:00;119;72;47
streda;5.6.2019;16:00;214;129;85
streda;5.6.2019;17:00;222;120;102
streda;5.6.2019;18:00;230;132;98
streda;5.6.2019;19:00;157;74;83
streda;5.6.2019;20:00;79;41;38
streda;5.6.2019;21:00;24;13;11
streda;5.6.2019;22:00;12;6;6
streda;5.6.2019;23:00;8;6;2
štvrtok;6.6.2019;0:00;6;6;0
štvrtok;6.6.2019;1:00;1;0;1
štvrtok;6.6.2019;2:00;1;0;1
štvrtok;6.6.2019;3:00;0;0;0
štvrtok;6.6.2019;4:00;1;1;0
štvrtok;6.6.2019;5:00;14;7;7
štvrtok;6.6.2019;6:00;49;30;19
štvrtok;6.6.2019;7:00;80;32;48
štvrtok;6.6.2019;8:00;90;40;50
štvrtok;6.6.2019;9:00;60;27;33
štvrtok;6.6.2019;10:00;34;16;18
štvrtok;6.6.2019;11:00;37;18;19
štvrtok;6.6.2019;12:00;32;20;12
štvrtok;6.6.2019;13:00;71;18;53
štvrtok;6.6.2019;14:00;60;41;19
štvrtok;6.6.2019;15:00;61;30;31
štvrtok;6.6.2019;16:00;111;58;53
štvrtok;6.6.2019;17:00;182;107;75
štvrtok;6.6.2019;18:00;122;71;51
štvrtok;6.6.2019;19:00;106;56;50
štvrtok;6.6.2019;20:00;51;24;27
štvrtok;6.6.2019;21:00;16;11;5
štvrtok;6.6.2019;22:00;13;6;7
štvrtok;6.6.2019;23:00;2;0;2
piatok;7.6.2019;0:00;3;0;3
piatok;7.6.2019;1:00;1;0;1
piatok;7.6.2019;2:00;0;0;0
piatok;7.6.2019;3:00;0;0;0
piatok;7.6.2019;4:00;4;1;3
piatok;7.6.2019;5:00;8;3;5
piatok;7.6.2019;6:00;46;27;19
piatok;7.6.2019;7:00;59;32;27
piatok;7.6.2019;8:00;99;43;56
piatok;7.6.2019;9:00;61;27;34
piatok;7.6.2019;10:00;46;23;23
piatok;7.6.2019;11:00;51;28;23
piatok;7.6.2019;12:00;54;27;27
piatok;7.6.2019;13:00;87;49;38
piatok;7.6.2019;14:00;109;59;50
piatok;7.6.2019;15:00;116;57;59
piatok;7.6.2019;16:00;186;99;87
piatok;7.6.2019;17:00;214;111;103
piatok;7.6.2019;18:00;189;104;85
piatok;7.6.2019;19:00;178;96;82
piatok;7.6.2019;20:00;101;54;47
piatok;7.6.2019;21:00;44;22;22
piatok;7.6.2019;22:00;17;8;9
piatok;7.6.2019;23:00;7;5;2
sobota;8.6.2019;0:00;3;2;1
sobota;8.6.2019;1:00;1;1;0
sobota;8.6.2019;2:00;10;7;3
sobota;8.6.2019;3:00;0;0;0
sobota;8.6.2019;4:00;1;0;1
sobota;8.6.2019;5:00;5;2;3
sobota;8.6.2019;6:00;19;15;4
sobota;8.6.2019;7:00;30;23;7
sobota;8.6.2019;8:00;53;30;23
sobota;8.6.2019;9:00;112;75;37
sobota;8.6.2019;10:00;126;90;36
sobota;8.6.2019;11:00;157;85;72
sobota;8.6.2019;12:00;134;61;73
sobota;8.6.2019;13:00;138;73;65
sobota;8.6.2019;14:00;174;82;92
sobota;8.6.2019;15:00;241;121;120
sobota;8.6.2019;16:00;228;97;131
sobota;8.6.2019;17:00;184;78;106
sobota;8.6.2019;18:00;185;115;70
sobota;8.6.2019;19:00;146;63;83
sobota;8.6.2019;20:00;92;49;43
sobota;8.6.2019;21:00;30;16;14
sobota;8.6.2019;22:00;12;8;4
sobota;8.6.2019;23:00;3;2;1
nedeľa;9.6.2019;0:00;1;0;1
nedeľa;9.6.2019;1:00;4;1;3
nedeľa;9.6.2019;2:00;5;2;3
nedeľa;9.6.2019;3:00;1;0;1
nedeľa;9.6.2019;4:00;2;1;1
nedeľa;9.6.2019;5:00;4;2;2
nedeľa;9.6.2019;6:00;19;15;4
nedeľa;9.6.2019;7:00;34;20;14
nedeľa;9.6.2019;8:00;118;88;30
nedeľa;9.6.2019;9:00;222;130;92
nedeľa;9.6.2019;10:00;324;207;117
nedeľa;9.6.2019;11:00;347;190;157
nedeľa;9.6.2019;12:00;249;108;141
nedeľa;9.6.2019;13:00;233;113;120
nedeľa;9.6.2019;14:00;326;183;143
nedeľa;9.6.2019;15:00;307;162;145
nedeľa;9.6.2019;16:00;318;161;157
nedeľa;9.6.2019;17:00;322;152;170
nedeľa;9.6.2019;18:00;277;158;119
nedeľa;9.6.2019;19:00;209;104;105
nedeľa;9.6.2019;20:00;101;47;54
nedeľa;9.6.2019;21:00;32;14;18
nedeľa;9.6.2019;22:00;16;4;12
nedeľa;9.6.2019;23:00;7;2;5
pondelok;10.6.2019;0:00;3;3;0
pondelok;10.6.2019;1:00;2;0;2
pondelok;10.6.2019;2:00;0;0;0
pondelok;10.6.2019;3:00;0;0;0
pondelok;10.6.2019;4:00;4;2;2
pondelok;10.6.2019;5:00;14;7;7
pondelok;10.6.2019;6:00;62;32;30
pondelok;10.6.2019;7:00;83;38;45
pondelok;10.6.2019;8:00;153;68;85
pondelok;10.6.2019;9:00;104;56;48
pondelok;10.6.2019;10:00;83;45;38
pondelok;10.6.2019;11:00;72;38;34
pondelok;10.6.2019;12:00;73;42;31
pondelok;10.6.2019;13:00;56;28;28
pondelok;10.6.2019;14:00;71;38;33
pondelok;10.6.2019;15:00;125;77;48
pondelok;10.6.2019;16:00;182;88;94
pondelok;10.6.2019;17:00;239;131;108
pondelok;10.6.2019;18:00;218;131;87
pondelok;10.6.2019;19:00;208;116;92
pondelok;10.6.2019;20:00;139;83;56
pondelok;10.6.2019;21:00;46;25;21
pondelok;10.6.2019;22:00;12;7;5
pondelok;10.6.2019;23:00;9;5;4
utorok;11.6.2019;0:00;3;1;2
utorok;11.6.2019;1:00;3;3;0
utorok;11.6.2019;2:00;1;0;1
utorok;11.6.2019;3:00;0;0;0
utorok;11.6.2019;4:00;3;1;2
utorok;11.6.2019;5:00;19;10;9
utorok;11.6.2019;6:00;71;44;27
utorok;11.6.2019;7:00;126;56;70
utorok;11.6.2019;8:00;155;72;83
utorok;11.6.2019;9:00;102;44;58
utorok;11.6.2019;10:00;66;36;30
utorok;11.6.2019;11:00;56;36;20
utorok;11.6.2019;12:00;58;28;30
utorok;11.6.2019;13:00;42;17;25
utorok;11.6.2019;14:00;53;29;24
utorok;11.6.2019;15:00;112;64;48
utorok;11.6.2019;16:00;197;115;82
utorok;11.6.2019;17:00;303;194;109
utorok;11.6.2019;18:00;220;109;111
utorok;11.6.2019;19:00;230;115;115
utorok;11.6.2019;20:00;112;52;60
utorok;11.6.2019;21:00;53;33;20
utorok;11.6.2019;22:00;11;8;3
utorok;11.6.2019;23:00;9;3;6
streda;12.6.2019;0:00;1;1;0
streda;12.6.2019;1:00;1;1;0
streda;12.6.2019;2:00;0;0;0
streda;12.6.2019;3:00;1;0;1
streda;12.6.2019;4:00;3;0;3
streda;12.6.2019;5:00;28;15;13
streda;12.6.2019;6:00;68;39;29
streda;12.6.2019;7:00;127;58;69
streda;12.6.2019;8:00;150;71;79
streda;12.6.2019;9:00;94;43;51
streda;12.6.2019;10:00;78;31;47
streda;12.6.2019;11:00;67;31;36
streda;12.6.2019;12:00;44;22;22
streda;12.6.2019;13:00;55;25;30
streda;12.6.2019;14:00;87;43;44
streda;12.6.2019;15:00;125;69;56
streda;12.6.2019;16:00;182;107;75
streda;12.6.2019;17:00;251;162;89
streda;12.6.2019;18:00;228;120;108
streda;12.6.2019;19:00;232;124;108
streda;12.6.2019;20:00;150;76;74
streda;12.6.2019;21:00;71;37;34
streda;12.6.2019;22:00;27;16;11
streda;12.6.2019;23:00;13;4;9
štvrtok;13.6.2019;0:00;1;0;1
štvrtok;13.6.2019;1:00;2;2;0
štvrtok;13.6.2019;2:00;0;0;0
štvrtok;13.6.2019;3:00;0;0;0
štvrtok;13.6.2019;4:00;3;2;1
štvrtok;13.6.2019;5:00;22;7;15
štvrtok;13.6.2019;6:00;72;41;31
štvrtok;13.6.2019;7:00;115;53;62
štvrtok;13.6.2019;8:00;153;77;76
štvrtok;13.6.2019;9:00;88;53;35
štvrtok;13.6.2019;10:00;57;28;29
štvrtok;13.6.2019;11:00;64;30;34
štvrtok;13.6.2019;12:00;46;20;26
štvrtok;13.6.2019;13:00;63;32;31
štvrtok;13.6.2019;14:00;65;36;29
štvrtok;13.6.2019;15:00;95;50;45
štvrtok;13.6.2019;16:00;156;85;71
štvrtok;13.6.2019;17:00;206;128;78
štvrtok;13.6.2019;18:00;210;115;95
štvrtok;13.6.2019;19:00;173;100;73
štvrtok;13.6.2019;20:00;107;53;54
štvrtok;13.6.2019;21:00;75;43;32
štvrtok;13.6.2019;22:00;22;12;10
štvrtok;13.6.2019;23:00;6;3;3
piatok;14.6.2019;0:00;1;1;0
piatok;14.6.2019;1:00;2;0;2
piatok;14.6.2019;2:00;0;0;0
piatok;14.6.2019;3:00;0;0;0
piatok;14.6.2019;4:00;3;0;3
piatok;14.6.2019;5:00;18;10;8
piatok;14.6.2019;6:00;60;33;27
piatok;14.6.2019;7:00;74;41;33
piatok;14.6.2019;8:00;95;55;40
piatok;14.6.2019;9:00;78;39;39
piatok;14.6.2019;10:00;65;15;50
piatok;14.6.2019;11:00;69;44;25
piatok;14.6.2019;12:00;56;30;26
piatok;14.6.2019;13:00;62;32;30
piatok;14.6.2019;14:00;74;33;41
piatok;14.6.2019;15:00;120;51;69
piatok;14.6.2019;16:00;172;81;91
piatok;14.6.2019;17:00;156;84;72
piatok;14.6.2019;18:00;143;76;67
piatok;14.6.2019;19:00;160;92;68
piatok;14.6.2019;20:00;125;66;59
piatok;14.6.2019;21:00;56;24;32
piatok;14.6.2019;22:00;23;15;8
piatok;14.6.2019;23:00;13;6;7
sobota;15.6.2019;0:00;7;3;4
sobota;15.6.2019;1:00;12;6;6
sobota;15.6.2019;2:00;1;0;1
sobota;15.6.2019;3:00;0;0;0
sobota;15.6.2019;4:00;4;3;1
sobota;15.6.2019;5:00;8;5;3
sobota;15.6.2019;6:00;20;15;5
sobota;15.6.2019;7:00;64;40;24
sobota;15.6.2019;8:00;101;65;36
sobota;15.6.2019;9:00;147;83;64
sobota;15.6.2019;10:00;128;58;70
sobota;15.6.2019;11:00;150;72;78
sobota;15.6.2019;12:00;114;59;55
sobota;15.6.2019;13:00;109;57;52
sobota;15.6.2019;14:00;139;83;56
sobota;15.6.2019;15:00;149;74;75
sobota;15.6.2019;16:00;132;74;58
sobota;15.6.2019;17:00;186;96;90
sobota;15.6.2019;18:00;146;75;71
sobota;15.6.2019;19:00;148;77;71
sobota;15.6.2019;20:00;102;53;49
sobota;15.6.2019;21:00;41;26;15
sobota;15.6.2019;22:00;26;16;10
sobota;15.6.2019;23:00;10;2;8
nedeľa;16.6.2019;0:00;13;3;10
nedeľa;16.6.2019;1:00;2;1;1
nedeľa;16.6.2019;2:00;2;0;2
nedeľa;16.6.2019;3:00;1;0;1
nedeľa;16.6.2019;4:00;2;2;0
nedeľa;16.6.2019;5:00;6;2;4
nedeľa;16.6.2019;6:00;19;13;6
nedeľa;16.6.2019;7:00;48;30;18
nedeľa;16.6.2019;8:00;61;31;30
nedeľa;16.6.2019;9:00;127;74;53
nedeľa;16.6.2019;10:00;149;69;80
nedeľa;16.6.2019;11:00;166;63;103
nedeľa;16.6.2019;12:00;111;65;46
nedeľa;16.6.2019;13:00;84;40;44
nedeľa;16.6.2019;14:00;101;43;58
nedeľa;16.6.2019;15:00;123;61;62
nedeľa;16.6.2019;16:00;143;70;73
nedeľa;16.6.2019;17:00;145;79;66
nedeľa;16.6.2019;18:00;148;82;66
nedeľa;16.6.2019;19:00;100;63;37
nedeľa;16.6.2019;20:00;64;28;36
nedeľa;16.6.2019;21:00;18;10;8
nedeľa;16.6.2019;22:00;7;4;3
nedeľa;16.6.2019;23:00;4;1;3
pondelok;17.6.2019;0:00;0;0;0
pondelok;17.6.2019;1:00;3;0;3
pondelok;17.6.2019;2:00;1;0;1
pondelok;17.6.2019;3:00;0;0;0
pondelok;17.6.2019;4:00;3;0;3
pondelok;17.6.2019;5:00;16;6;10
pondelok;17.6.2019;6:00;45;26;19
pondelok;17.6.2019;7:00;72;39;33
pondelok;17.6.2019;8:00;122;43;79
pondelok;17.6.2019;9:00;108;30;78
pondelok;17.6.2019;10:00;61;21;40
pondelok;17.6.2019;11:00;60;36;24
pondelok;17.6.2019;12:00;102;51;51
pondelok;17.6.2019;13:00;44;21;23
pondelok;17.6.2019;14:00;50;26;24
pondelok;17.6.2019;15:00;94;49;45
pondelok;17.6.2019;16:00;152;78;74
pondelok;17.6.2019;17:00;178;98;80
pondelok;17.6.2019;18:00;197;121;76
pondelok;17.6.2019;19:00;179;91;88
pondelok;17.6.2019;20:00;95;63;32
pondelok;17.6.2019;21:00;58;43;15
pondelok;17.6.2019;22:00;10;4;6
pondelok;17.6.2019;23:00;7;4;3
utorok;18.6.2019;0:00;0;0;0
utorok;18.6.2019;1:00;0;0;0
utorok;18.6.2019;2:00;0;0;0
utorok;18.6.2019;3:00;0;0;0
utorok;18.6.2019;4:00;4;2;2
utorok;18.6.2019;5:00;21;10;11
utorok;18.6.2019;6:00;74;43;31
utorok;18.6.2019;7:00;94;43;51
utorok;18.6.2019;8:00;124;59;65
utorok;18.6.2019;9:00;107;40;67
utorok;18.6.2019;10:00;86;45;41
utorok;18.6.2019;11:00;85;50;35
utorok;18.6.2019;12:00;77;29;48
utorok;18.6.2019;13:00;55;22;33
utorok;18.6.2019;14:00;69;29;40
utorok;18.6.2019;15:00;126;68;58
utorok;18.6.2019;16:00;220;128;92
utorok;18.6.2019;17:00;343;224;119
utorok;18.6.2019;18:00;299;181;118
utorok;18.6.2019;19:00;289;147;142
utorok;18.6.2019;20:00;174;98;76
utorok;18.6.2019;21:00;74;42;32
utorok;18.6.2019;22:00;10;6;4
utorok;18.6.2019;23:00;10;4;6
streda;19.6.2019;0:00;6;2;4
streda;19.6.2019;1:00;5;3;2
streda;19.6.2019;2:00;0;0;0
streda;19.6.2019;3:00;3;0;3
streda;19.6.2019;4:00;5;4;1
streda;19.6.2019;5:00;20;9;11
streda;19.6.2019;6:00;51;33;18
streda;19.6.2019;7:00;89;45;44
streda;19.6.2019;8:00;116;47;69
streda;19.6.2019;9:00;71;28;43
streda;19.6.2019;10:00;61;16;45
streda;19.6.2019;11:00;68;41;27
streda;19.6.2019;12:00;51;29;22
streda;19.6.2019;13:00;48;26;22
streda;19.6.2019;14:00;53;33;20
streda;19.6.2019;15:00;98;46;52
streda;19.6.2019;16:00;149;86;63
streda;19.6.2019;17:00;219;135;84
streda;19.6.2019;18:00;247;128;119
streda;19.6.2019;19:00;197;105;92
streda;19.6.2019;20:00;114;75;39
streda;19.6.2019;21:00;48;22;26
streda;19.6.2019;22:00;16;9;7
streda;19.6.2019;23:00;4;3;1
štvrtok;20.6.2019;0:00;3;1;2
štvrtok;20.6.2019;1:00;1;0;1
štvrtok;20.6.2019;2:00;1;0;1
štvrtok;20.6.2019;3:00;0;0;0
štvrtok;20.6.2019;4:00;2;1;1
štvrtok;20.6.2019;5:00;15;8;7
štvrtok;20.6.2019;6:00;61;35;26
štvrtok;20.6.2019;7:00;78;31;47
štvrtok;20.6.2019;8:00;105;44;61
štvrtok;20.6.2019;9:00;64;22;42
štvrtok;20.6.2019;10:00;73;40;33
štvrtok;20.6.2019;11:00;53;27;26
štvrtok;20.6.2019;12:00;71;38;33
štvrtok;20.6.2019;13:00;59;30;29
štvrtok;20.6.2019;14:00;77;43;34
štvrtok;20.6.2019;15:00;119;62;57
štvrtok;20.6.2019;16:00;212;118;94
štvrtok;20.6.2019;17:00;262;171;91
štvrtok;20.6.2019;18:00;223;131;92
štvrtok;20.6.2019;19:00;225;112;113
štvrtok;20.6.2019;20:00;128;77;51
štvrtok;20.6.2019;21:00;63;31;32
štvrtok;20.6.2019;22:00;21;12;9
štvrtok;20.6.2019;23:00;9;8;1
piatok;21.6.2019;0:00;4;0;4
piatok;21.6.2019;1:00;2;1;1
piatok;21.6.2019;2:00;0;0;0
piatok;21.6.2019;3:00;0;0;0
piatok;21.6.2019;4:00;1;1;0
piatok;21.6.2019;5:00;19;11;8
piatok;21.6.2019;6:00;40;22;18
piatok;21.6.2019;7:00;72;36;36
piatok;21.6.2019;8:00;101;48;53
piatok;21.6.2019;9:00;48;21;27
piatok;21.6.2019;10:00;56;30;26
piatok;21.6.2019;11:00;63;34;29
piatok;21.6.2019;12:00;55;33;22
piatok;21.6.2019;13:00;63;31;32
piatok;21.6.2019;14:00;115;53;62
piatok;21.6.2019;15:00;131;57;74
piatok;21.6.2019;16:00;177;93;84
piatok;21.6.2019;17:00;199;117;82
piatok;21.6.2019;18:00;186;105;81
piatok;21.6.2019;19:00;151;76;75
piatok;21.6.2019;20:00;119;77;42
piatok;21.6.2019;21:00;68;43;25
piatok;21.6.2019;22:00;24;6;18
piatok;21.6.2019;23:00;13;8;5
sobota;22.6.2019;0:00;22;15;7
sobota;22.6.2019;1:00;11;10;1
sobota;22.6.2019;2:00;2;2;0
sobota;22.6.2019;3:00;2;1;1
sobota;22.6.2019;4:00;1;1;0
sobota;22.6.2019;5:00;8;3;5
sobota;22.6.2019;6:00;18;10;8
sobota;22.6.2019;7:00;40;28;12
sobota;22.6.2019;8:00;77;50;27
sobota;22.6.2019;9:00;111;61;50
sobota;22.6.2019;10:00;191;107;84
sobota;22.6.2019;11:00;159;76;83
sobota;22.6.2019;12:00;197;121;76
sobota;22.6.2019;13:00;141;89;52
sobota;22.6.2019;14:00;177;90;87
sobota;22.6.2019;15:00;171;86;85
sobota;22.6.2019;16:00;154;74;80
sobota;22.6.2019;17:00;115;47;68
sobota;22.6.2019;18:00;74;39;35
sobota;22.6.2019;19:00;53;27;26
sobota;22.6.2019;20:00;30;17;13
sobota;22.6.2019;21:00;4;2;2
sobota;22.6.2019;22:00;5;3;2
sobota;22.6.2019;23:00;2;2;0
nedeľa;23.6.2019;0:00;4;3;1
nedeľa;23.6.2019;1:00;1;1;0
nedeľa;23.6.2019;2:00;1;1;0
nedeľa;23.6.2019;3:00;0;0;0
nedeľa;23.6.2019;4:00;0;0;0
nedeľa;23.6.2019;5:00;5;2;3
nedeľa;23.6.2019;6:00;4;3;1
nedeľa;23.6.2019;7:00;2;1;1
nedeľa;23.6.2019;8:00;6;2;4
nedeľa;23.6.2019;9:00;16;7;9
nedeľa;23.6.2019;10:00;30;10;20
nedeľa;23.6.2019;11:00;41;21;20
nedeľa;23.6.2019;12:00;33;12;21
nedeľa;23.6.2019;13:00;41;13;28
nedeľa;23.6.2019;14:00;44;23;21
nedeľa;23.6.2019;15:00;46;29;17
nedeľa;23.6.2019;16:00;158;89;69
nedeľa;23.6.2019;17:00;73;43;30
nedeľa;23.6.2019;18:00;49;25;24
nedeľa;23.6.2019;19:00;39;22;17
nedeľa;23.6.2019;20:00;33;17;16
nedeľa;23.6.2019;21:00;7;1;6
nedeľa;23.6.2019;22:00;3;0;3
nedeľa;23.6.2019;23:00;6;2;4
pondelok;24.6.2019;0:00;0;0;0
pondelok;24.6.2019;1:00;0;0;0
pondelok;24.6.2019;2:00;2;0;2
pondelok;24.6.2019;3:00;1;1;0
pondelok;24.6.2019;4:00;2;1;1
pondelok;24.6.2019;5:00;17;10;7
pondelok;24.6.2019;6:00;44;25;19
pondelok;24.6.2019;7:00;74;39;35
pondelok;24.6.2019;8:00;117;54;63
pondelok;24.6.2019;9:00;66;25;41
pondelok;24.6.2019;10:00;71;31;40
pondelok;24.6.2019;11:00;77;51;26
pondelok;24.6.2019;12:00;55;26;29
pondelok;24.6.2019;13:00;59;22;37
pondelok;24.6.2019;14:00;72;32;40
pondelok;24.6.2019;15:00;130;74;56
pondelok;24.6.2019;16:00;242;129;113
pondelok;24.6.2019;17:00;262;145;117
pondelok;24.6.2019;18:00;288;157;131
pondelok;24.6.2019;19:00;242;125;117
pondelok;24.6.2019;20:00;163;106;57
pondelok;24.6.2019;21:00;51;32;19
pondelok;24.6.2019;22:00;30;15;15
pondelok;24.6.2019;23:00;7;4;3
utorok;25.6.2019;0:00;1;0;1
utorok;25.6.2019;1:00;1;0;1
utorok;25.6.2019;2:00;0;0;0
utorok;25.6.2019;3:00;1;1;0
utorok;25.6.2019;4:00;0;0;0
utorok;25.6.2019;5:00;41;24;17
utorok;25.6.2019;6:00;69;43;26
utorok;25.6.2019;7:00;138;68;70
utorok;25.6.2019;8:00;149;62;87
utorok;25.6.2019;9:00;108;68;40
utorok;25.6.2019;10:00;78;45;33
utorok;25.6.2019;11:00;94;55;39
utorok;25.6.2019;12:00;69;37;32
utorok;25.6.2019;13:00;67;23;44
utorok;25.6.2019;14:00;66;39;27
utorok;25.6.2019;15:00;121;64;57
utorok;25.6.2019;16:00;175;82;93
utorok;25.6.2019;17:00;313;184;129
utorok;25.6.2019;18:00;275;164;111
utorok;25.6.2019;19:00;286;152;134
utorok;25.6.2019;20:00;206;110;96
utorok;25.6.2019;21:00;88;49;39
utorok;25.6.2019;22:00;26;15;11
utorok;25.6.2019;23:00;11;8;3
streda;26.6.2019;0:00;1;0;1
streda;26.6.2019;1:00;1;0;1
streda;26.6.2019;2:00;0;0;0
streda;26.6.2019;3:00;0;0;0
streda;26.6.2019;4:00;4;3;1
streda;26.6.2019;5:00;27;15;12
streda;26.6.2019;6:00;75;40;35
streda;26.6.2019;7:00;128;66;62
streda;26.6.2019;8:00;135;62;73
streda;26.6.2019;9:00;78;46;32
streda;26.6.2019;10:00;48;25;23
streda;26.6.2019;11:00;55;31;24
streda;26.6.2019;12:00;49;20;29
streda;26.6.2019;13:00;61;34;27
streda;26.6.2019;14:00;85;33;52
streda;26.6.2019;15:00;108;53;55
streda;26.6.2019;16:00;150;76;74
streda;26.6.2019;17:00;240;150;90
streda;26.6.2019;18:00;238;138;100
streda;26.6.2019;19:00;193;102;91
streda;26.6.2019;20:00;184;94;90
streda;26.6.2019;21:00;91;50;41
streda;26.6.2019;22:00;27;12;15
streda;26.6.2019;23:00;12;9;3
štvrtok;27.6.2019;0:00;6;2;4
štvrtok;27.6.2019;1:00;1;0;1
štvrtok;27.6.2019;2:00;0;0;0
štvrtok;27.6.2019;3:00;0;0;0
štvrtok;27.6.2019;4:00;1;1;0
štvrtok;27.6.2019;5:00;29;20;9
štvrtok;27.6.2019;6:00;75;39;36
štvrtok;27.6.2019;7:00;109;57;52
štvrtok;27.6.2019;8:00;128;74;54
štvrtok;27.6.2019;9:00;90;49;41
štvrtok;27.6.2019;10:00;47;26;21
štvrtok;27.6.2019;11:00;41;14;27
štvrtok;27.6.2019;12:00;48;20;28
štvrtok;27.6.2019;13:00;43;20;23
štvrtok;27.6.2019;14:00;63;36;27
štvrtok;27.6.2019;15:00;75;37;38
štvrtok;27.6.2019;16:00;132;63;69
štvrtok;27.6.2019;17:00;218;142;76
štvrtok;27.6.2019;18:00;171;84;87
štvrtok;27.6.2019;19:00;165;80;85
štvrtok;27.6.2019;20:00;131;65;66
štvrtok;27.6.2019;21:00;61;38;23
štvrtok;27.6.2019;22:00;19;10;9
štvrtok;27.6.2019;23:00;16;12;4
piatok;28.6.2019;0:00;5;3;2
piatok;28.6.2019;1:00;3;3;0
piatok;28.6.2019;2:00;0;0;0
piatok;28.6.2019;3:00;0;0;0
piatok;28.6.2019;4:00;3;1;2
piatok;28.6.2019;5:00;16;10;6
piatok;28.6.2019;6:00;63;33;30
piatok;28.6.2019;7:00;91;52;39
piatok;28.6.2019;8:00;112;56;56
piatok;28.6.2019;9:00;72;43;29
piatok;28.6.2019;10:00;63;23;40
piatok;28.6.2019;11:00;58;29;29
piatok;28.6.2019;12:00;46;20;26
piatok;28.6.2019;13:00;57;31;26
piatok;28.6.2019;14:00;82;42;40
piatok;28.6.2019;15:00;85;37;48
piatok;28.6.2019;16:00;182;92;90
piatok;28.6.2019;17:00;173;93;80
piatok;28.6.2019;18:00;194;108;86
piatok;28.6.2019;19:00;145;80;65
piatok;28.6.2019;20:00;127;68;59
piatok;28.6.2019;21:00;52;30;22
piatok;28.6.2019;22:00;23;15;8
piatok;28.6.2019;23:00;10;9;1
sobota;29.6.2019;0:00;9;7;2
sobota;29.6.2019;1:00;6;2;4
sobota;29.6.2019;2:00;3;1;2
sobota;29.6.2019;3:00;2;2;0
sobota;29.6.2019;4:00;2;0;2
sobota;29.6.2019;5:00;12;6;6
sobota;29.6.2019;6:00;18;13;5
sobota;29.6.2019;7:00;52;35;17
sobota;29.6.2019;8:00;86;51;35
sobota;29.6.2019;9:00;159;90;69
sobota;29.6.2019;10:00;225;145;80
sobota;29.6.2019;11:00;220;128;92
sobota;29.6.2019;12:00;169;90;79
sobota;29.6.2019;13:00;153;74;79
sobota;29.6.2019;14:00;175;76;99
sobota;29.6.2019;15:00;181;82;99
sobota;29.6.2019;16:00;242;120;122
sobota;29.6.2019;17:00;236;131;105
sobota;29.6.2019;18:00;228;121;107
sobota;29.6.2019;19:00;182;83;99
sobota;29.6.2019;20:00;130;84;46
sobota;29.6.2019;21:00;60;34;26
sobota;29.6.2019;22:00;15;9;6
sobota;29.6.2019;23:00;7;3;4
nedeľa;30.6.2019;0:00;4;3;1
nedeľa;30.6.2019;1:00;8;6;2
nedeľa;30.6.2019;2:00;1;1;0
nedeľa;30.6.2019;3:00;1;1;0
nedeľa;30.6.2019;4:00;0;0;0
nedeľa;30.6.2019;5:00;5;3;2
nedeľa;30.6.2019;6:00;18;12;6
nedeľa;30.6.2019;7:00;56;33;23
nedeľa;30.6.2019;8:00;95;54;41
nedeľa;30.6.2019;9:00;142;75;67
nedeľa;30.6.2019;10:00;168;96;72
nedeľa;30.6.2019;11:00;154;79;75
nedeľa;30.6.2019;12:00;146;78;68
nedeľa;30.6.2019;13:00;96;50;46
nedeľa;30.6.2019;14:00;97;47;50
nedeľa;30.6.2019;15:00;106;48;58
nedeľa;30.6.2019;16:00;159;82;77
nedeľa;30.6.2019;17:00;170;92;78
nedeľa;30.6.2019;18:00;171;88;83
nedeľa;30.6.2019;19:00;167;86;81
nedeľa;30.6.2019;20:00;91;62;29
nedeľa;30.6.2019;21:00;55;33;22
nedeľa;30.6.2019;22:00;18;13;5
nedeľa;30.6.2019;23:00;3;0;3
pondelok;1.7.2019;0:00;7;2;5
pondelok;1.7.2019;1:00;1;1;0
pondelok;1.7.2019;2:00;0;0;0
pondelok;1.7.2019;3:00;0;0;0
pondelok;1.7.2019;4:00;4;2;2
pondelok;1.7.2019;5:00;24;14;10
pondelok;1.7.2019;6:00;59;26;33
pondelok;1.7.2019;7:00;112;61;51
pondelok;1.7.2019;8:00;131;62;69
pondelok;1.7.2019;9:00;78;36;42
pondelok;1.7.2019;10:00;52;29;23
pondelok;1.7.2019;11:00;42;19;23
pondelok;1.7.2019;12:00;42;21;21
pondelok;1.7.2019;13:00;40;18;22
pondelok;1.7.2019;14:00;40;15;25
pondelok;1.7.2019;15:00;93;50;43
pondelok;1.7.2019;16:00;129;67;62
pondelok;1.7.2019;17:00;185;92;93
pondelok;1.7.2019;18:00;182;105;77
pondelok;1.7.2019;19:00;76;48;28
pondelok;1.7.2019;20:00;33;22;11
pondelok;1.7.2019;21:00;8;6;2
pondelok;1.7.2019;22:00;6;3;3
pondelok;1.7.2019;23:00;4;3;1
utorok;2.7.2019;0:00;1;1;0
utorok;2.7.2019;1:00;0;0;0
utorok;2.7.2019;2:00;0;0;0
utorok;2.7.2019;3:00;0;0;0
utorok;2.7.2019;4:00;3;2;1
utorok;2.7.2019;5:00;21;12;9
utorok;2.7.2019;6:00;69;43;26
utorok;2.7.2019;7:00;112;56;56
utorok;2.7.2019;8:00;112;51;61
utorok;2.7.2019;9:00;71;36;35
utorok;2.7.2019;10:00;98;60;38
utorok;2.7.2019;11:00;63;25;38
utorok;2.7.2019;12:00;63;30;33
utorok;2.7.2019;13:00;55;29;26
utorok;2.7.2019;14:00;101;54;47
utorok;2.7.2019;15:00;107;56;51
utorok;2.7.2019;16:00;188;101;87
utorok;2.7.2019;17:00;288;166;122
utorok;2.7.2019;18:00;276;164;112
utorok;2.7.2019;19:00;276;149;127
utorok;2.7.2019;20:00;156;85;71
utorok;2.7.2019;21:00;51;39;12
utorok;2.7.2019;22:00;21;10;11
utorok;2.7.2019;23:00;8;5;3
streda;3.7.2019;0:00;5;3;2
streda;3.7.2019;1:00;2;1;1
streda;3.7.2019;2:00;0;0;0
streda;3.7.2019;3:00;0;0;0
streda;3.7.2019;4:00;3;1;2
streda;3.7.2019;5:00;19;10;9
streda;3.7.2019;6:00;54;29;25
streda;3.7.2019;7:00;102;52;50
streda;3.7.2019;8:00;130;64;66
streda;3.7.2019;9:00;91;47;44
streda;3.7.2019;10:00;71;36;35
streda;3.7.2019;11:00;85;42;43
streda;3.7.2019;12:00;68;34;34
streda;3.7.2019;13:00;58;31;27
streda;3.7.2019;14:00;86;42;44
streda;3.7.2019;15:00;127;68;59
streda;3.7.2019;16:00;192;112;80
streda;3.7.2019;17:00;266;153;113
streda;3.7.2019;18:00;271;129;142
streda;3.7.2019;19:00;247;135;112
streda;3.7.2019;20:00;122;65;57
streda;3.7.2019;21:00;55;28;27
streda;3.7.2019;22:00;21;13;8
streda;3.7.2019;23:00;20;17;3
štvrtok;4.7.2019;0:00;5;3;2
štvrtok;4.7.2019;1:00;1;1;0
štvrtok;4.7.2019;2:00;2;2;0
štvrtok;4.7.2019;3:00;0;0;0
štvrtok;4.7.2019;4:00;2;0;2
štvrtok;4.7.2019;5:00;26;19;7
štvrtok;4.7.2019;6:00;52;27;25
štvrtok;4.7.2019;7:00;87;39;48
štvrtok;4.7.2019;8:00;100;48;52
štvrtok;4.7.2019;9:00;67;37;30
štvrtok;4.7.2019;10:00;92;45;47
štvrtok;4.7.2019;11:00;92;33;59
štvrtok;4.7.2019;12:00;59;28;31
štvrtok;4.7.2019;13:00;60;30;30
štvrtok;4.7.2019;14:00;71;38;33
štvrtok;4.7.2019;15:00;127;71;56
štvrtok;4.7.2019;16:00;185;95;90
štvrtok;4.7.2019;17:00;221;135;86
štvrtok;4.7.2019;18:00;156;80;76
štvrtok;4.7.2019;19:00;180;97;83
štvrtok;4.7.2019;20:00;130;71;59
štvrtok;4.7.2019;21:00;68;42;26
štvrtok;4.7.2019;22:00;23;14;9
štvrtok;4.7.2019;23:00;5;2;3
piatok;5.7.2019;0:00;5;3;2
piatok;5.7.2019;1:00;0;0;0
piatok;5.7.2019;2:00;1;1;0
piatok;5.7.2019;3:00;0;0;0
piatok;5.7.2019;4:00;1;1;0
piatok;5.7.2019;5:00;10;7;3
piatok;5.7.2019;6:00;23;15;8
piatok;5.7.2019;7:00;69;47;22
piatok;5.7.2019;8:00;94;65;29
piatok;5.7.2019;9:00;123;75;48
piatok;5.7.2019;10:00;182;118;64
piatok;5.7.2019;11:00;192;110;82
piatok;5.7.2019;12:00;200;81;119
piatok;5.7.2019;13:00;160;72;88
piatok;5.7.2019;14:00;180;103;77
piatok;5.7.2019;15:00;199;111;88
piatok;5.7.2019;16:00;214;114;100
piatok;5.7.2019;17:00;223;100;123
piatok;5.7.2019;18:00;193;80;113
piatok;5.7.2019;19:00;156;82;74
piatok;5.7.2019;20:00;95;45;50
piatok;5.7.2019;21:00;44;26;18
piatok;5.7.2019;22:00;24;11;13
piatok;5.7.2019;23:00;7;4;3
sobota;6.7.2019;0:00;4;2;2
sobota;6.7.2019;1:00;1;1;0
sobota;6.7.2019;2:00;0;0;0
sobota;6.7.2019;3:00;0;0;0
sobota;6.7.2019;4:00;2;1;1
sobota;6.7.2019;5:00;10;7;3
sobota;6.7.2019;6:00;15;7;8
sobota;6.7.2019;7:00;44;29;15
sobota;6.7.2019;8:00;54;34;20
sobota;6.7.2019;9:00;122;76;46
sobota;6.7.2019;10:00;146;91;55
sobota;6.7.2019;11:00;126;67;59
sobota;6.7.2019;12:00;142;62;80
sobota;6.7.2019;13:00;116;47;69
sobota;6.7.2019;14:00;131;71;60
sobota;6.7.2019;15:00;119;67;52
sobota;6.7.2019;16:00;114;52;62
sobota;6.7.2019;17:00;147;75;72
sobota;6.7.2019;18:00;153;69;84
sobota;6.7.2019;19:00;132;64;68
sobota;6.7.2019;20:00;103;57;46
sobota;6.7.2019;21:00;24;19;5
sobota;6.7.2019;22:00;8;6;2
sobota;6.7.2019;23:00;9;6;3
nedeľa;7.7.2019;0:00;6;0;6
nedeľa;7.7.2019;1:00;2;2;0
nedeľa;7.7.2019;2:00;0;0;0
nedeľa;7.7.2019;3:00;2;0;2
nedeľa;7.7.2019;4:00;2;1;1
nedeľa;7.7.2019;5:00;3;2;1
nedeľa;7.7.2019;6:00;12;7;5
nedeľa;7.7.2019;7:00;23;10;13
nedeľa;7.7.2019;8:00;66;39;27
nedeľa;7.7.2019;9:00;83;48;35
nedeľa;7.7.2019;10:00;112;73;39
nedeľa;7.7.2019;11:00;119;44;75
nedeľa;7.7.2019;12:00;113;63;50
nedeľa;7.7.2019;13:00;116;57;59
nedeľa;7.7.2019;14:00;96;40;56
nedeľa;7.7.2019;15:00;83;40;43
nedeľa;7.7.2019;16:00;65;32;33
nedeľa;7.7.2019;17:00;133;83;50
nedeľa;7.7.2019;18:00;105;54;51
nedeľa;7.7.2019;19:00;77;36;41
nedeľa;7.7.2019;20:00;53;25;28
nedeľa;7.7.2019;21:00;16;8;8
nedeľa;7.7.2019;22:00;4;4;0
nedeľa;7.7.2019;23:00;4;3;1
pondelok;8.7.2019;0:00;4;2;2
pondelok;8.7.2019;1:00;1;0;1
pondelok;8.7.2019;2:00;0;0;0
pondelok;8.7.2019;3:00;1;1;0
pondelok;8.7.2019;4:00;2;0;2
pondelok;8.7.2019;5:00;15;9;6
pondelok;8.7.2019;6:00;28;13;15
pondelok;8.7.2019;7:00;53;26;27
pondelok;8.7.2019;8:00;93;38;55
pondelok;8.7.2019;9:00;53;29;24
pondelok;8.7.2019;10:00;64;32;32
pondelok;8.7.2019;11:00;56;27;29
pondelok;8.7.2019;12:00;54;27;27
pondelok;8.7.2019;13:00;61;26;35
pondelok;8.7.2019;14:00;93;50;43
pondelok;8.7.2019;15:00;114;63;51
pondelok;8.7.2019;16:00;163;83;80
pondelok;8.7.2019;17:00;231;118;113
pondelok;8.7.2019;18:00;196;109;87
pondelok;8.7.2019;19:00;170;83;87
pondelok;8.7.2019;20:00;105;54;51
pondelok;8.7.2019;21:00;41;23;18
pondelok;8.7.2019;22:00;12;4;8
pondelok;8.7.2019;23:00;17;14;3
utorok;9.7.2019;0:00;3;1;2
utorok;9.7.2019;1:00;1;0;1
utorok;9.7.2019;2:00;0;0;0
utorok;9.7.2019;3:00;0;0;0
utorok;9.7.2019;4:00;3;2;1
utorok;9.7.2019;5:00;25;18;7
utorok;9.7.2019;6:00;60;36;24
utorok;9.7.2019;7:00;112;54;58
utorok;9.7.2019;8:00;139;65;74
utorok;9.7.2019;9:00;87;46;41
utorok;9.7.2019;10:00;87;32;55
utorok;9.7.2019;11:00;81;45;36
utorok;9.7.2019;12:00;67;26;41
utorok;9.7.2019;13:00;59;17;42
utorok;9.7.2019;14:00;89;57;32
utorok;9.7.2019;15:00;156;68;88
utorok;9.7.2019;16:00;171;103;68
utorok;9.7.2019;17:00;302;176;126
utorok;9.7.2019;18:00;263;141;122
utorok;9.7.2019;19:00;226;122;104
utorok;9.7.2019;20:00;144;81;63
utorok;9.7.2019;21:00;47;17;30
utorok;9.7.2019;22:00;21;17;4
utorok;9.7.2019;23:00;9;8;1
streda;10.7.2019;0:00;1;0;1
streda;10.7.2019;1:00;2;0;2
streda;10.7.2019;2:00;0;0;0
streda;10.7.2019;3:00;1;0;1
streda;10.7.2019;4:00;2;1;1
streda;10.7.2019;5:00;15;11;4
streda;10.7.2019;6:00;61;33;28
streda;10.7.2019;7:00;98;47;51
streda;10.7.2019;8:00;144;80;64
streda;10.7.2019;9:00;87;40;47
streda;10.7.2019;10:00;78;34;44
streda;10.7.2019;11:00;48;21;27
streda;10.7.2019;12:00;49;20;29
streda;10.7.2019;13:00;43;26;17
streda;10.7.2019;14:00;71;30;41
streda;10.7.2019;15:00;128;77;51
streda;10.7.2019;16:00;202;116;86
streda;10.7.2019;17:00;219;129;90
streda;10.7.2019;18:00;175;91;84
streda;10.7.2019;19:00;180;100;80
streda;10.7.2019;20:00;99;44;55
streda;10.7.2019;21:00;39;20;19
streda;10.7.2019;22:00;18;11;7
streda;10.7.2019;23:00;5;5;0
štvrtok;11.7.2019;0:00;3;0;3
štvrtok;11.7.2019;1:00;1;1;0
štvrtok;11.7.2019;2:00;7;2;5
štvrtok;11.7.2019;3:00;0;0;0
štvrtok;11.7.2019;4:00;2;1;1
štvrtok;11.7.2019;5:00;16;6;10
štvrtok;11.7.2019;6:00;61;42;19
štvrtok;11.7.2019;7:00;81;38;43
štvrtok;11.7.2019;8:00;97;48;49
štvrtok;11.7.2019;9:00;77;41;36
štvrtok;11.7.2019;10:00;98;63;35
štvrtok;11.7.2019;11:00;91;40;51
štvrtok;11.7.2019;12:00;63;33;30
štvrtok;11.7.2019;13:00;72;33;39
štvrtok;11.7.2019;14:00;101;45;56
štvrtok;11.7.2019;15:00;150;81;69
štvrtok;11.7.2019;16:00;176;87;89
štvrtok;11.7.2019;17:00;282;170;112
štvrtok;11.7.2019;18:00;232;134;98
štvrtok;11.7.2019;19:00;216;116;100
štvrtok;11.7.2019;20:00;149;78;71
štvrtok;11.7.2019;21:00;45;24;21
štvrtok;11.7.2019;22:00;12;8;4
štvrtok;11.7.2019;23:00;8;5;3
piatok;12.7.2019;0:00;4;1;3
piatok;12.7.2019;1:00;1;0;1
piatok;12.7.2019;2:00;0;0;0
piatok;12.7.2019;3:00;0;0;0
piatok;12.7.2019;4:00;1;1;0
piatok;12.7.2019;5:00;7;5;2
piatok;12.7.2019;6:00;25;13;12
piatok;12.7.2019;7:00;40;19;21
piatok;12.7.2019;8:00;39;30;9
piatok;12.7.2019;9:00;14;5;9
piatok;12.7.2019;10:00;16;7;9
piatok;12.7.2019;11:00;24;3;21
piatok;12.7.2019;12:00;8;6;2
piatok;12.7.2019;13:00;13;9;4
piatok;12.7.2019;14:00;33;13;20
piatok;12.7.2019;15:00;31;10;21
piatok;12.7.2019;16:00;71;32;39
piatok;12.7.2019;17:00;65;35;30
piatok;12.7.2019;18:00;86;40;46
piatok;12.7.2019;19:00;73;40;33
piatok;12.7.2019;20:00;45;25;20
piatok;12.7.2019;21:00;11;5;6
piatok;12.7.2019;22:00;5;2;3
piatok;12.7.2019;23:00;3;0;3
sobota;13.7.2019;0:00;0;0;0
sobota;13.7.2019;1:00;4;2;2
sobota;13.7.2019;2:00;0;0;0
sobota;13.7.2019;3:00;0;0;0
sobota;13.7.2019;4:00;1;0;1
sobota;13.7.2019;5:00;5;3;2
sobota;13.7.2019;6:00;7;7;0
sobota;13.7.2019;7:00;2;2;0
sobota;13.7.2019;8:00;24;11;13
sobota;13.7.2019;9:00;27;11;16
sobota;13.7.2019;10:00;41;21;20
sobota;13.7.2019;11:00;27;8;19
sobota;13.7.2019;12:00;15;10;5
sobota;13.7.2019;13:00;20;8;12
sobota;13.7.2019;14:00;13;8;5
sobota;13.7.2019;15:00;13;4;9
sobota;13.7.2019;16:00;30;14;16
sobota;13.7.2019;17:00;42;21;21
sobota;13.7.2019;18:00;52;29;23
sobota;13.7.2019;19:00;45;27;18
sobota;13.7.2019;20:00;9;6;3
sobota;13.7.2019;21:00;12;5;7
sobota;13.7.2019;22:00;4;3;1
sobota;13.7.2019;23:00;1;1;0
nedeľa;14.7.2019;0:00;1;0;1
nedeľa;14.7.2019;1:00;2;0;2
nedeľa;14.7.2019;2:00;1;0;1
nedeľa;14.7.2019;3:00;2;0;2
nedeľa;14.7.2019;4:00;0;0;0
nedeľa;14.7.2019;5:00;4;3;1
nedeľa;14.7.2019;6:00;8;3;5
nedeľa;14.7.2019;7:00;20;12;8
nedeľa;14.7.2019;8:00;53;26;27
nedeľa;14.7.2019;9:00;86;62;24
nedeľa;14.7.2019;10:00;174;110;64
nedeľa;14.7.2019;11:00;169;99;70
nedeľa;14.7.2019;12:00;211;104;107
nedeľa;14.7.2019;13:00;200;123;77
nedeľa;14.7.2019;14:00;229;99;130
nedeľa;14.7.2019;15:00;206;118;88
nedeľa;14.7.2019;16:00;210;87;123
nedeľa;14.7.2019;17:00;197;102;95
nedeľa;14.7.2019;18:00;169;93;76
nedeľa;14.7.2019;19:00;89;48;41
nedeľa;14.7.2019;20:00;59;30;29
nedeľa;14.7.2019;21:00;18;15;3
nedeľa;14.7.2019;22:00;8;5;3
nedeľa;14.7.2019;23:00;6;5;1
pondelok;15.7.2019;0:00;2;0;2
pondelok;15.7.2019;1:00;0;0;0
pondelok;15.7.2019;2:00;1;0;1
pondelok;15.7.2019;3:00;1;1;0
pondelok;15.7.2019;4:00;3;2;1
pondelok;15.7.2019;5:00;12;6;6
pondelok;15.7.2019;6:00;46;23;23
pondelok;15.7.2019;7:00;69;34;35
pondelok;15.7.2019;8:00;103;54;49
pondelok;15.7.2019;9:00;89;32;57
pondelok;15.7.2019;10:00;65;27;38
pondelok;15.7.2019;11:00;68;34;34
pondelok;15.7.2019;12:00;47;21;26
pondelok;15.7.2019;13:00;74;33;41
pondelok;15.7.2019;14:00;91;46;45
pondelok;15.7.2019;15:00;144;76;68
pondelok;15.7.2019;16:00;211;102;109
pondelok;15.7.2019;17:00;277;148;129
pondelok;15.7.2019;18:00;249;139;110
pondelok;15.7.2019;19:00;199;104;95
pondelok;15.7.2019;20:00;129;72;57
pondelok;15.7.2019;21:00;40;23;17
pondelok;15.7.2019;22:00;30;20;10
pondelok;15.7.2019;23:00;9;5;4
utorok;16.7.2019;0:00;1;1;0
utorok;16.7.2019;1:00;0;0;0
utorok;16.7.2019;2:00;1;1;0
utorok;16.7.2019;3:00;0;0;0
utorok;16.7.2019;4:00;1;0;1
utorok;16.7.2019;5:00;17;12;5
utorok;16.7.2019;6:00;61;34;27
utorok;16.7.2019;7:00;92;42;50
utorok;16.7.2019;8:00;139;63;76
utorok;16.7.2019;9:00;112;50;62
utorok;16.7.2019;10:00;139;70;69
utorok;16.7.2019;11:00;84;46;38
utorok;16.7.2019;12:00;93;39;54
utorok;16.7.2019;13:00;90;50;40
utorok;16.7.2019;14:00;86;45;41
utorok;16.7.2019;15:00;180;91;89
utorok;16.7.2019;16:00;278;145;133
utorok;16.7.2019;17:00;395;250;145
utorok;16.7.2019;18:00;278;164;114
utorok;16.7.2019;19:00;293;129;164
utorok;16.7.2019;20:00;152;81;71
utorok;16.7.2019;21:00;48;30;18
utorok;16.7.2019;22:00;19;10;9
utorok;16.7.2019;23:00;14;13;1
streda;17.7.2019;0:00;10;6;4
streda;17.7.2019;1:00;1;1;0
streda;17.7.2019;2:00;0;0;0
streda;17.7.2019;3:00;0;0;0
streda;17.7.2019;4:00;2;1;1
streda;17.7.2019;5:00;13;9;4
streda;17.7.2019;6:00;61;34;27
streda;17.7.2019;7:00;107;53;54
streda;17.7.2019;8:00;138;65;73
streda;17.7.2019;9:00;107;53;54
streda;17.7.2019;10:00;77;38;39
streda;17.7.2019;11:00;82;34;48
streda;17.7.2019;12:00;93;53;40
streda;17.7.2019;13:00;73;39;34
streda;17.7.2019;14:00;104;59;45
streda;17.7.2019;15:00;206;101;105
streda;17.7.2019;16:00;238;132;106
streda;17.7.2019;17:00;314;170;144
streda;17.7.2019;18:00;287;139;148
streda;17.7.2019;19:00;250;129;121
streda;17.7.2019;20:00;174;86;88
streda;17.7.2019;21:00;64;39;25
streda;17.7.2019;22:00;26;18;8
streda;17.7.2019;23:00;12;11;1
štvrtok;18.7.2019;0:00;2;0;2
štvrtok;18.7.2019;1:00;2;2;0
štvrtok;18.7.2019;2:00;0;0;0
štvrtok;18.7.2019;3:00;0;0;0
štvrtok;18.7.2019;4:00;0;0;0
štvrtok;18.7.2019;5:00;9;6;3
štvrtok;18.7.2019;6:00;49;32;17
štvrtok;18.7.2019;7:00;83;42;41
štvrtok;18.7.2019;8:00;102;46;56
štvrtok;18.7.2019;9:00;76;40;36
štvrtok;18.7.2019;10:00;70;49;21
štvrtok;18.7.2019;11:00;58;31;27
štvrtok;18.7.2019;12:00;90;56;34
štvrtok;18.7.2019;13:00;79;32;47
štvrtok;18.7.2019;14:00;104;59;45
štvrtok;18.7.2019;15:00;157;61;96
štvrtok;18.7.2019;16:00;221;121;100
štvrtok;18.7.2019;17:00;263;162;101
štvrtok;18.7.2019;18:00;275;160;115
štvrtok;18.7.2019;19:00;224;119;105
štvrtok;18.7.2019;20:00;164;95;69
štvrtok;18.7.2019;21:00;63;40;23
štvrtok;18.7.2019;22:00;18;8;10
štvrtok;18.7.2019;23:00;6;5;1
piatok;19.7.2019;0:00;3;1;2
piatok;19.7.2019;1:00;3;1;2
piatok;19.7.2019;2:00;1;1;0
piatok;19.7.2019;3:00;0;0;0
piatok;19.7.2019;4:00;1;1;0
piatok;19.7.2019;5:00;10;5;5
piatok;19.7.2019;6:00;33;22;11
piatok;19.7.2019;7:00;82;40;42
piatok;19.7.2019;8:00;112;62;50
piatok;19.7.2019;9:00;77;46;31
piatok;19.7.2019;10:00;74;38;36
piatok;19.7.2019;11:00;71;31;40
piatok;19.7.2019;12:00;62;35;27
piatok;19.7.2019;13:00;86;50;36
piatok;19.7.2019;14:00;105;55;50
piatok;19.7.2019;15:00;150;75;75
piatok;19.7.2019;16:00;122;53;69
piatok;19.7.2019;17:00;160;90;70
piatok;19.7.2019;18:00;136;81;55
piatok;19.7.2019;19:00;146;79;67
piatok;19.7.2019;20:00;100;48;52
piatok;19.7.2019;21:00;54;30;24
piatok;19.7.2019;22:00;57;10;47
piatok;19.7.2019;23:00;14;10;4
sobota;20.7.2019;0:00;5;2;3
sobota;20.7.2019;1:00;4;2;2
sobota;20.7.2019;2:00;1;0;1
sobota;20.7.2019;3:00;2;2;0
sobota;20.7.2019;4:00;2;2;0
sobota;20.7.2019;5:00;2;1;1
sobota;20.7.2019;6:00;16;10;6
sobota;20.7.2019;7:00;53;37;16
sobota;20.7.2019;8:00;58;43;15
sobota;20.7.2019;9:00;133;80;53
sobota;20.7.2019;10:00;191;110;81
sobota;20.7.2019;11:00;190;101;89
sobota;20.7.2019;12:00;169;88;81
sobota;20.7.2019;13:00;170;102;68
sobota;20.7.2019;14:00;149;83;66
sobota;20.7.2019;15:00;151;66;85
sobota;20.7.2019;16:00;172;83;89
sobota;20.7.2019;17:00;163;87;76
sobota;20.7.2019;18:00;186;90;96
sobota;20.7.2019;19:00;149;79;70
sobota;20.7.2019;20:00;107;38;69
sobota;20.7.2019;21:00;43;25;18
sobota;20.7.2019;22:00;28;19;9
sobota;20.7.2019;23:00;20;10;10
nedeľa;21.7.2019;0:00;4;3;1
nedeľa;21.7.2019;1:00;2;0;2
nedeľa;21.7.2019;2:00;3;1;2
nedeľa;21.7.2019;3:00;0;0;0
nedeľa;21.7.2019;4:00;3;1;2
nedeľa;21.7.2019;5:00;5;4;1
nedeľa;21.7.2019;6:00;20;11;9
nedeľa;21.7.2019;7:00;30;24;6
nedeľa;21.7.2019;8:00;72;46;26
nedeľa;21.7.2019;9:00;153;82;71
nedeľa;21.7.2019;10:00;182;113;69
nedeľa;21.7.2019;11:00;169;89;80
nedeľa;21.7.2019;12:00;149;70;79
nedeľa;21.7.2019;13:00;155;64;91
nedeľa;21.7.2019;14:00;122;58;64
nedeľa;21.7.2019;15:00;127;71;56
nedeľa;21.7.2019;16:00;121;50;71
nedeľa;21.7.2019;17:00;162;80;82
nedeľa;21.7.2019;18:00;156;83;73
nedeľa;21.7.2019;19:00;141;75;66
nedeľa;21.7.2019;20:00;83;42;41
nedeľa;21.7.2019;21:00;43;24;19
nedeľa;21.7.2019;22:00;13;5;8
nedeľa;21.7.2019;23:00;12;11;1
pondelok;22.7.2019;0:00;3;2;1
pondelok;22.7.2019;1:00;2;0;2
pondelok;22.7.2019;2:00;1;0;1
pondelok;22.7.2019;3:00;1;1;0
pondelok;22.7.2019;4:00;0;0;0
pondelok;22.7.2019;5:00;10;7;3
pondelok;22.7.2019;6:00;48;28;20
pondelok;22.7.2019;7:00;84;42;42
pondelok;22.7.2019;8:00;105;42;63
pondelok;22.7.2019;9:00;84;38;46
pondelok;22.7.2019;10:00;89;26;63
pondelok;22.7.2019;11:00;66;33;33
pondelok;22.7.2019;12:00;91;39;52
pondelok;22.7.2019;13:00;55;25;30
pondelok;22.7.2019;14:00;84;41;43
pondelok;22.7.2019;15:00;130;64;66
pondelok;22.7.2019;16:00;196;103;93
pondelok;22.7.2019;17:00;311;187;124
pondelok;22.7.2019;18:00;304;155;149
pondelok;22.7.2019;19:00;236;131;105
pondelok;22.7.2019;20:00;170;82;88
pondelok;22.7.2019;21:00;67;35;32
pondelok;22.7.2019;22:00;25;16;9
pondelok;22.7.2019;23:00;16;14;2
utorok;23.7.2019;0:00;5;0;5
utorok;23.7.2019;1:00;3;1;2
utorok;23.7.2019;2:00;1;1;0
utorok;23.7.2019;3:00;0;0;0
utorok;23.7.2019;4:00;1;0;1
utorok;23.7.2019;5:00;19;8;11
utorok;23.7.2019;6:00;87;53;34
utorok;23.7.2019;7:00;106;56;50
utorok;23.7.2019;8:00;139;77;62
utorok;23.7.2019;9:00;106;41;65
utorok;23.7.2019;10:00;141;78;63
utorok;23.7.2019;11:00;75;33;42
utorok;23.7.2019;12:00;72;28;44
utorok;23.7.2019;13:00;84;29;55
utorok;23.7.2019;14:00;88;41;47
utorok;23.7.2019;15:00;146;67;79
utorok;23.7.2019;16:00;226;114;112
utorok;23.7.2019;17:00;315;186;129
utorok;23.7.2019;18:00;266;153;113
utorok;23.7.2019;19:00;262;109;153
utorok;23.7.2019;20:00;186;103;83
utorok;23.7.2019;21:00;80;45;35
utorok;23.7.2019;22:00;32;24;8
utorok;23.7.2019;23:00;30;22;8
streda;24.7.2019;0:00;3;1;2
streda;24.7.2019;1:00;1;0;1
streda;24.7.2019;2:00;3;1;2
streda;24.7.2019;3:00;0;0;0
streda;24.7.2019;4:00;1;0;1
streda;24.7.2019;5:00;21;11;10
streda;24.7.2019;6:00;77;43;34
streda;24.7.2019;7:00;99;61;38
streda;24.7.2019;8:00;142;62;80
streda;24.7.2019;9:00;108;60;48
streda;24.7.2019;10:00;74;37;37
streda;24.7.2019;11:00;80;43;37
streda;24.7.2019;12:00;97;36;61
streda;24.7.2019;13:00;58;28;30
streda;24.7.2019;14:00;88;39;49
streda;24.7.2019;15:00;135;76;59
streda;24.7.2019;16:00;175;83;92
streda;24.7.2019;17:00;270;165;105
streda;24.7.2019;18:00;262;153;109
streda;24.7.2019;19:00;269;140;129
streda;24.7.2019;20:00;203;107;96
streda;24.7.2019;21:00;81;53;28
streda;24.7.2019;22:00;21;17;4
streda;24.7.2019;23:00;12;10;2
štvrtok;25.7.2019;0:00;5;3;2
štvrtok;25.7.2019;1:00;5;1;4
štvrtok;25.7.2019;2:00;0;0;0
štvrtok;25.7.2019;3:00;0;0;0
štvrtok;25.7.2019;4:00;0;0;0
štvrtok;25.7.2019;5:00;20;13;7
štvrtok;25.7.2019;6:00;70;37;33
štvrtok;25.7.2019;7:00;111;53;58
štvrtok;25.7.2019;8:00;171;83;88
štvrtok;25.7.2019;9:00;110;57;53
štvrtok;25.7.2019;10:00;70;38;32
štvrtok;25.7.2019;11:00;65;32;33
štvrtok;25.7.2019;12:00;46;20;26
štvrtok;25.7.2019;13:00;64;32;32
štvrtok;25.7.2019;14:00;74;27;47
štvrtok;25.7.2019;15:00;106;53;53
štvrtok;25.7.2019;16:00;190;100;90
štvrtok;25.7.2019;17:00;246;146;100
štvrtok;25.7.2019;18:00;232;123;109
štvrtok;25.7.2019;19:00;186;97;89
štvrtok;25.7.2019;20:00;166;86;80
štvrtok;25.7.2019;21:00;57;34;23
štvrtok;25.7.2019;22:00;22;12;10
štvrtok;25.7.2019;23:00;16;5;11
piatok;26.7.2019;0:00;4;0;4
piatok;26.7.2019;1:00;4;4;0
piatok;26.7.2019;2:00;0;0;0
piatok;26.7.2019;3:00;1;1;0
piatok;26.7.2019;4:00;3;0;3
piatok;26.7.2019;5:00;11;10;1
piatok;26.7.2019;6:00;68;39;29
piatok;26.7.2019;7:00;87;39;48
piatok;26.7.2019;8:00;118;60;58
piatok;26.7.2019;9:00;108;57;51
piatok;26.7.2019;10:00;88;39;49
piatok;26.7.2019;11:00;54;27;27
piatok;26.7.2019;12:00;66;33;33
piatok;26.7.2019;13:00;66;19;47
piatok;26.7.2019;14:00;86;51;35
piatok;26.7.2019;15:00;108;51;57
piatok;26.7.2019;16:00;134;72;62
piatok;26.7.2019;17:00;171;89;82
piatok;26.7.2019;18:00;156;81;75
piatok;26.7.2019;19:00;164;93;71
piatok;26.7.2019;20:00;119;64;55
piatok;26.7.2019;21:00;59;35;24
piatok;26.7.2019;22:00;24;16;8
piatok;26.7.2019;23:00;6;2;4
sobota;27.7.2019;0:00;6;4;2
sobota;27.7.2019;1:00;3;0;3
sobota;27.7.2019;2:00;6;3;3
sobota;27.7.2019;3:00;3;0;3
sobota;27.7.2019;4:00;2;0;2
sobota;27.7.2019;5:00;2;0;2
sobota;27.7.2019;6:00;8;7;1
sobota;27.7.2019;7:00;36;20;16
sobota;27.7.2019;8:00;55;29;26
sobota;27.7.2019;9:00;84;51;33
sobota;27.7.2019;10:00;79;42;37
sobota;27.7.2019;11:00;18;5;13
sobota;27.7.2019;12:00;28;11;17
sobota;27.7.2019;13:00;19;7;12
sobota;27.7.2019;14:00;39;28;11
sobota;27.7.2019;15:00;37;18;19
sobota;27.7.2019;16:00;76;27;49
sobota;27.7.2019;17:00;46;30;16
sobota;27.7.2019;18:00;47;28;19
sobota;27.7.2019;19:00;28;15;13
sobota;27.7.2019;20:00;24;12;12
sobota;27.7.2019;21:00;9;4;5
sobota;27.7.2019;22:00;5;2;3
sobota;27.7.2019;23:00;5;3;2
nedeľa;28.7.2019;0:00;1;0;1
nedeľa;28.7.2019;1:00;2;2;0
nedeľa;28.7.2019;2:00;3;1;2
nedeľa;28.7.2019;3:00;0;0;0
nedeľa;28.7.2019;4:00;2;1;1
nedeľa;28.7.2019;5:00;1;1;0
nedeľa;28.7.2019;6:00;6;4;2
nedeľa;28.7.2019;7:00;12;9;3
nedeľa;28.7.2019;8:00;51;33;18
nedeľa;28.7.2019;9:00;54;21;33
nedeľa;28.7.2019;10:00;25;11;14
nedeľa;28.7.2019;11:00;86;43;43
nedeľa;28.7.2019;12:00;91;53;38
nedeľa;28.7.2019;13:00;125;76;49
nedeľa;28.7.2019;14:00;139;68;71
nedeľa;28.7.2019;15:00;227;112;115
nedeľa;28.7.2019;16:00;222;119;103
nedeľa;28.7.2019;17:00;189;105;84
nedeľa;28.7.2019;18:00;110;67;43
nedeľa;28.7.2019;19:00;104;49;55
nedeľa;28.7.2019;20:00;54;25;29
nedeľa;28.7.2019;21:00;12;9;3
nedeľa;28.7.2019;22:00;11;10;1
nedeľa;28.7.2019;23:00;4;2;2
pondelok;29.7.2019;0:00;1;0;1
pondelok;29.7.2019;1:00;0;0;0
pondelok;29.7.2019;2:00;0;0;0
pondelok;29.7.2019;3:00;2;0;2
pondelok;29.7.2019;4:00;0;0;0
pondelok;29.7.2019;5:00;9;5;4
pondelok;29.7.2019;6:00;19;8;11
pondelok;29.7.2019;7:00;62;28;34
pondelok;29.7.2019;8:00;82;40;42
pondelok;29.7.2019;9:00;70;25;45
pondelok;29.7.2019;10:00;53;16;37
pondelok;29.7.2019;11:00;56;34;22
pondelok;29.7.2019;12:00;57;32;25
pondelok;29.7.2019;13:00;37;22;15
pondelok;29.7.2019;14:00;73;31;42
pondelok;29.7.2019;15:00;112;56;56
pondelok;29.7.2019;16:00;181;91;90
pondelok;29.7.2019;17:00;226;132;94
pondelok;29.7.2019;18:00;253;145;108
pondelok;29.7.2019;19:00;215;120;95
pondelok;29.7.2019;20:00;144;78;66
pondelok;29.7.2019;21:00;35;19;16
pondelok;29.7.2019;22:00;26;18;8
pondelok;29.7.2019;23:00;5;4;1
utorok;30.7.2019;0:00;4;3;1
utorok;30.7.2019;1:00;0;0;0
utorok;30.7.2019;2:00;0;0;0
utorok;30.7.2019;3:00;0;0;0
utorok;30.7.2019;4:00;1;1;0
utorok;30.7.2019;5:00;19;15;4
utorok;30.7.2019;6:00;70;41;29
utorok;30.7.2019;7:00;108;54;54
utorok;30.7.2019;8:00;163;87;76
utorok;30.7.2019;9:00;130;54;76
utorok;30.7.2019;10:00;98;43;55
utorok;30.7.2019;11:00;85;40;45
utorok;30.7.2019;12:00;84;39;45
utorok;30.7.2019;13:00;94;57;37
utorok;30.7.2019;14:00;101;45;56
utorok;30.7.2019;15:00;118;59;59
utorok;30.7.2019;16:00;206;104;102
utorok;30.7.2019;17:00;229;139;90
utorok;30.7.2019;18:00;189;88;101
utorok;30.7.2019;19:00;245;132;113
utorok;30.7.2019;20:00;121;60;61
utorok;30.7.2019;21:00;58;33;25
utorok;30.7.2019;22:00;37;25;12
utorok;30.7.2019;23:00;18;12;6
streda;31.7.2019;0:00;3;1;2
streda;31.7.2019;1:00;0;0;0
streda;31.7.2019;2:00;0;0;0
streda;31.7.2019;3:00;0;0;0
streda;31.7.2019;4:00;1;0;1
streda;31.7.2019;5:00;17;11;6
streda;31.7.2019;6:00;43;25;18
streda;31.7.2019;7:00;75;44;31
streda;31.7.2019;8:00;150;88;62
streda;31.7.2019;9:00;103;44;59
streda;31.7.2019;10:00;109;48;61
streda;31.7.2019;11:00;74;32;42
streda;31.7.2019;12:00;91;41;50
streda;31.7.2019;13:00;57;26;31
streda;31.7.2019;14:00;104;47;57
streda;31.7.2019;15:00;186;72;114
streda;31.7.2019;16:00;219;122;97
streda;31.7.2019;17:00;254;143;111
streda;31.7.2019;18:00;264;147;117
streda;31.7.2019;19:00;263;132;131
streda;31.7.2019;20:00;126;68;58
streda;31.7.2019;21:00;54;35;19
streda;31.7.2019;22:00;16;9;7
streda;31.7.2019;23:00;6;5;1
štvrtok;1.8.2019;0:00;4;2;2
štvrtok;1.8.2019;1:00;0;0;0
štvrtok;1.8.2019;2:00;0;0;0
štvrtok;1.8.2019;3:00;0;0;0
štvrtok;1.8.2019;4:00;0;0;0
štvrtok;1.8.2019;5:00;27;24;3
štvrtok;1.8.2019;6:00;67;38;29
štvrtok;1.8.2019;7:00;92;46;46
štvrtok;1.8.2019;8:00;150;85;65
štvrtok;1.8.2019;9:00;85;50;35
štvrtok;1.8.2019;10:00;66;35;31
štvrtok;1.8.2019;11:00;106;54;52
štvrtok;1.8.2019;12:00;71;31;40
štvrtok;1.8.2019;13:00;83;41;42
štvrtok;1.8.2019;14:00;94;45;49
štvrtok;1.8.2019;15:00;137;73;64
štvrtok;1.8.2019;16:00;239;111;128
štvrtok;1.8.2019;17:00;313;182;131
štvrtok;1.8.2019;18:00;301;164;137
štvrtok;1.8.2019;19:00;255;136;119
štvrtok;1.8.2019;20:00;187;89;98
štvrtok;1.8.2019;21:00;49;28;21
štvrtok;1.8.2019;22:00;29;18;11
štvrtok;1.8.2019;23:00;8;5;3
piatok;2.8.2019;0:00;7;4;3
piatok;2.8.2019;1:00;0;0;0
piatok;2.8.2019;2:00;0;0;0
piatok;2.8.2019;3:00;2;2;0
piatok;2.8.2019;4:00;2;1;1
piatok;2.8.2019;5:00;11;8;3
piatok;2.8.2019;6:00;49;26;23
piatok;2.8.2019;7:00;62;34;28
piatok;2.8.2019;8:00;102;54;48
piatok;2.8.2019;9:00;91;49;42
piatok;2.8.2019;10:00;69;30;39
piatok;2.8.2019;11:00;65;21;44
piatok;2.8.2019;12:00;46;29;17
piatok;2.8.2019;13:00;57;22;35
piatok;2.8.2019;14:00;86;38;48
piatok;2.8.2019;15:00;125;53;72
piatok;2.8.2019;16:00;142;72;70
piatok;2.8.2019;17:00;155;68;87
piatok;2.8.2019;18:00;114;65;49
piatok;2.8.2019;19:00;104;54;50
piatok;2.8.2019;20:00;59;26;33
piatok;2.8.2019;21:00;30;13;17
piatok;2.8.2019;22:00;8;3;5
piatok;2.8.2019;23:00;7;4;3
sobota;3.8.2019;0:00;2;0;2
sobota;3.8.2019;1:00;0;0;0
sobota;3.8.2019;2:00;1;1;0
sobota;3.8.2019;3:00;2;0;2
sobota;3.8.2019;4:00;2;0;2
sobota;3.8.2019;5:00;4;1;3
sobota;3.8.2019;6:00;18;15;3
sobota;3.8.2019;7:00;18;12;6
sobota;3.8.2019;8:00;64;34;30
sobota;3.8.2019;9:00;113;73;40
sobota;3.8.2019;10:00;169;110;59
sobota;3.8.2019;11:00;119;66;53
sobota;3.8.2019;12:00;109;63;46
sobota;3.8.2019;13:00;140;70;70
sobota;3.8.2019;14:00;166;78;88
sobota;3.8.2019;15:00;167;78;89
sobota;3.8.2019;16:00;187;89;98
sobota;3.8.2019;17:00;125;61;64
sobota;3.8.2019;18:00;60;19;41
sobota;3.8.2019;19:00;51;15;36
sobota;3.8.2019;20:00;36;19;17
sobota;3.8.2019;21:00;17;8;9
sobota;3.8.2019;22:00;4;0;4
sobota;3.8.2019;23:00;8;8;0
nedeľa;4.8.2019;0:00;2;0;2
nedeľa;4.8.2019;1:00;0;0;0
nedeľa;4.8.2019;2:00;0;0;0
nedeľa;4.8.2019;3:00;0;0;0
nedeľa;4.8.2019;4:00;0;0;0
nedeľa;4.8.2019;5:00;2;1;1
nedeľa;4.8.2019;6:00;21;17;4
nedeľa;4.8.2019;7:00;34;26;8
nedeľa;4.8.2019;8:00;66;50;16
nedeľa;4.8.2019;9:00;133;75;58
nedeľa;4.8.2019;10:00;227;133;94
nedeľa;4.8.2019;11:00;323;180;143
nedeľa;4.8.2019;12:00;220;100;120
nedeľa;4.8.2019;13:00;278;155;123
nedeľa;4.8.2019;14:00;274;133;141
nedeľa;4.8.2019;15:00;315;154;161
nedeľa;4.8.2019;16:00;337;166;171
nedeľa;4.8.2019;17:00;334;136;198
nedeľa;4.8.2019;18:00;265;153;112
nedeľa;4.8.2019;19:00;242;134;108
nedeľa;4.8.2019;20:00;95;49;46
nedeľa;4.8.2019;21:00;42;26;16
nedeľa;4.8.2019;22:00;25;12;13
nedeľa;4.8.2019;23:00;5;4;1
pondelok;5.8.2019;0:00;1;0;1
pondelok;5.8.2019;1:00;0;0;0
pondelok;5.8.2019;2:00;0;0;0
pondelok;5.8.2019;3:00;0;0;0
pondelok;5.8.2019;4:00;2;1;1
pondelok;5.8.2019;5:00;16;9;7
pondelok;5.8.2019;6:00;43;24;19
pondelok;5.8.2019;7:00;83;48;35
pondelok;5.8.2019;8:00;113;42;71
pondelok;5.8.2019;9:00;103;41;62
pondelok;5.8.2019;10:00;95;42;53
pondelok;5.8.2019;11:00;114;57;57
pondelok;5.8.2019;12:00;98;36;62
pondelok;5.8.2019;13:00;83;35;48
pondelok;5.8.2019;14:00;86;40;46
pondelok;5.8.2019;15:00;156;93;63
pondelok;5.8.2019;16:00;209;114;95
pondelok;5.8.2019;17:00;278;148;130
pondelok;5.8.2019;18:00;315;189;126
pondelok;5.8.2019;19:00;283;148;135
pondelok;5.8.2019;20:00;154;81;73
pondelok;5.8.2019;21:00;37;23;14
pondelok;5.8.2019;22:00;19;11;8
pondelok;5.8.2019;23:00;12;5;7
utorok;6.8.2019;0:00;4;2;2
utorok;6.8.2019;1:00;0;0;0
utorok;6.8.2019;2:00;0;0;0
utorok;6.8.2019;3:00;0;0;0
utorok;6.8.2019;4:00;3;2;1
utorok;6.8.2019;5:00;20;11;9
utorok;6.8.2019;6:00;72;54;18
utorok;6.8.2019;7:00;90;48;42
utorok;6.8.2019;8:00;115;43;72
utorok;6.8.2019;9:00;112;49;63
utorok;6.8.2019;10:00;79;32;47
utorok;6.8.2019;11:00;66;24;42
utorok;6.8.2019;12:00;71;30;41
utorok;6.8.2019;13:00;54;23;31
utorok;6.8.2019;14:00;74;31;43
utorok;6.8.2019;15:00;125;57;68
utorok;6.8.2019;16:00;211;114;97
utorok;6.8.2019;17:00;334;205;129
utorok;6.8.2019;18:00;322;176;146
utorok;6.8.2019;19:00;330;184;146
utorok;6.8.2019;20:00;176;80;96
utorok;6.8.2019;21:00;58;24;34
utorok;6.8.2019;22:00;21;13;8
utorok;6.8.2019;23:00;15;7;8
streda;7.8.2019;0:00;3;1;2
streda;7.8.2019;1:00;2;0;2
streda;7.8.2019;2:00;0;0;0
streda;7.8.2019;3:00;2;0;2
streda;7.8.2019;4:00;3;2;1
streda;7.8.2019;5:00;19;13;6
streda;7.8.2019;6:00;50;29;21
streda;7.8.2019;7:00;97;44;53
streda;7.8.2019;8:00;116;53;63
streda;7.8.2019;9:00;96;47;49
streda;7.8.2019;10:00;107;44;63
streda;7.8.2019;11:00;86;49;37
streda;7.8.2019;12:00;94;47;47
streda;7.8.2019;13:00;82;41;41
streda;7.8.2019;14:00;85;39;46
streda;7.8.2019;15:00;131;62;69
streda;7.8.2019;16:00;214;123;91
streda;7.8.2019;17:00;315;188;127
streda;7.8.2019;18:00;271;136;135
streda;7.8.2019;19:00;224;105;119
streda;7.8.2019;20:00;162;73;89
streda;7.8.2019;21:00;53;36;17
streda;7.8.2019;22:00;6;5;1
streda;7.8.2019;23:00;8;7;1
štvrtok;8.8.2019;0:00;1;1;0
štvrtok;8.8.2019;1:00;4;3;1
štvrtok;8.8.2019;2:00;1;1;0
štvrtok;8.8.2019;3:00;0;0;0
štvrtok;8.8.2019;4:00;0;0;0
štvrtok;8.8.2019;5:00;9;7;2
štvrtok;8.8.2019;6:00;43;24;19
štvrtok;8.8.2019;7:00;83;39;44
štvrtok;8.8.2019;8:00;90;41;49
štvrtok;8.8.2019;9:00;86;32;54
štvrtok;8.8.2019;10:00;89;56;33
štvrtok;8.8.2019;11:00;78;35;43
štvrtok;8.8.2019;12:00;69;37;32
štvrtok;8.8.2019;13:00;78;43;35
štvrtok;8.8.2019;14:00;102;41;61
štvrtok;8.8.2019;15:00;133;65;68
štvrtok;8.8.2019;16:00;220;122;98
štvrtok;8.8.2019;17:00;373;233;140
štvrtok;8.8.2019;18:00;257;139;118
štvrtok;8.8.2019;19:00;247;111;136
štvrtok;8.8.2019;20:00;122;64;58
štvrtok;8.8.2019;21:00;26;15;11
štvrtok;8.8.2019;22:00;20;6;14
štvrtok;8.8.2019;23:00;10;5;5
piatok;9.8.2019;0:00;1;0;1
piatok;9.8.2019;1:00;2;1;1
piatok;9.8.2019;2:00;1;0;1
piatok;9.8.2019;3:00;0;0;0
piatok;9.8.2019;4:00;2;2;0
piatok;9.8.2019;5:00;19;17;2
piatok;9.8.2019;6:00;44;25;19
piatok;9.8.2019;7:00;88;44;44
piatok;9.8.2019;8:00;100;51;49
piatok;9.8.2019;9:00;126;51;75
piatok;9.8.2019;10:00;104;39;65
piatok;9.8.2019;11:00;96;50;46
piatok;9.8.2019;12:00;79;50;29
piatok;9.8.2019;13:00;78;28;50
piatok;9.8.2019;14:00;71;34;37
piatok;9.8.2019;15:00;174;79;95
piatok;9.8.2019;16:00;182;96;86
piatok;9.8.2019;17:00;189;101;88
piatok;9.8.2019;18:00;202;117;85
piatok;9.8.2019;19:00;188;103;85
piatok;9.8.2019;20:00;135;75;60
piatok;9.8.2019;21:00;38;16;22
piatok;9.8.2019;22:00;29;17;12
piatok;9.8.2019;23:00;23;12;11
sobota;10.8.2019;0:00;5;0;5
sobota;10.8.2019;1:00;2;0;2
sobota;10.8.2019;2:00;3;3;0
sobota;10.8.2019;3:00;2;1;1
sobota;10.8.2019;4:00;4;4;0
sobota;10.8.2019;5:00;7;5;2
sobota;10.8.2019;6:00;22;16;6
sobota;10.8.2019;7:00;59;44;15
sobota;10.8.2019;8:00;124;84;40
sobota;10.8.2019;9:00;148;96;52
sobota;10.8.2019;10:00;211;110;101
sobota;10.8.2019;11:00;169;92;77
sobota;10.8.2019;12:00;153;68;85
sobota;10.8.2019;13:00;137;54;83
sobota;10.8.2019;14:00;115;62;53
sobota;10.8.2019;15:00;145;74;71
sobota;10.8.2019;16:00;136;74;62
sobota;10.8.2019;17:00;147;68;79
sobota;10.8.2019;18:00;169;94;75
sobota;10.8.2019;19:00;91;35;56
sobota;10.8.2019;20:00;51;32;19
sobota;10.8.2019;21:00;22;9;13
sobota;10.8.2019;22:00;10;5;5
sobota;10.8.2019;23:00;14;4;10
nedeľa;11.8.2019;0:00;3;2;1
nedeľa;11.8.2019;1:00;2;1;1
nedeľa;11.8.2019;2:00;0;0;0
nedeľa;11.8.2019;3:00;1;1;0
nedeľa;11.8.2019;4:00;2;0;2
nedeľa;11.8.2019;5:00;1;0;1
nedeľa;11.8.2019;6:00;9;6;3
nedeľa;11.8.2019;7:00;23;13;10
nedeľa;11.8.2019;8:00;71;42;29
nedeľa;11.8.2019;9:00;97;61;36
nedeľa;11.8.2019;10:00;156;88;68
nedeľa;11.8.2019;11:00;195;106;89
nedeľa;11.8.2019;12:00;160;74;86
nedeľa;11.8.2019;13:00;181;82;99
nedeľa;11.8.2019;14:00;165;81;84
nedeľa;11.8.2019;15:00;205;105;100
nedeľa;11.8.2019;16:00;229;109;120
nedeľa;11.8.2019;17:00;263;134;129
nedeľa;11.8.2019;18:00;258;146;112
nedeľa;11.8.2019;19:00;195;79;116
nedeľa;11.8.2019;20:00;141;84;57
nedeľa;11.8.2019;21:00;36;20;16
nedeľa;11.8.2019;22:00;11;9;2
nedeľa;11.8.2019;23:00;7;0;7
pondelok;12.8.2019;0:00;3;2;1
pondelok;12.8.2019;1:00;0;0;0
pondelok;12.8.2019;2:00;0;0;0
pondelok;12.8.2019;3:00;0;0;0
pondelok;12.8.2019;4:00;1;1;0
pondelok;12.8.2019;5:00;14;5;9
pondelok;12.8.2019;6:00;46;22;24
pondelok;12.8.2019;7:00;84;42;42
pondelok;12.8.2019;8:00;115;50;65
pondelok;12.8.2019;9:00;127;60;67
pondelok;12.8.2019;10:00;73;30;43
pondelok;12.8.2019;11:00;87;27;60
pondelok;12.8.2019;12:00;69;33;36
pondelok;12.8.2019;13:00;62;18;44
pondelok;12.8.2019;14:00;92;38;54
pondelok;12.8.2019;15:00;93;48;45
pondelok;12.8.2019;16:00;172;88;84
pondelok;12.8.2019;17:00;219;115;104
pondelok;12.8.2019;18:00;191;115;76
pondelok;12.8.2019;19:00;154;83;71
pondelok;12.8.2019;20:00;88;48;40
pondelok;12.8.2019;21:00;19;11;8
pondelok;12.8.2019;22:00;14;9;5
pondelok;12.8.2019;23:00;5;4;1
utorok;13.8.2019;0:00;2;1;1
utorok;13.8.2019;1:00;0;0;0
utorok;13.8.2019;2:00;0;0;0
utorok;13.8.2019;3:00;0;0;0
utorok;13.8.2019;4:00;2;2;0
utorok;13.8.2019;5:00;10;2;8
utorok;13.8.2019;6:00;41;26;15
utorok;13.8.2019;7:00;76;28;48
utorok;13.8.2019;8:00;100;53;47
utorok;13.8.2019;9:00;94;40;54
utorok;13.8.2019;10:00;74;42;32
utorok;13.8.2019;11:00;88;26;62
utorok;13.8.2019;12:00;59;30;29
utorok;13.8.2019;13:00;48;24;24
utorok;13.8.2019;14:00;83;43;40
utorok;13.8.2019;15:00;117;67;50
utorok;13.8.2019;16:00;154;95;59
utorok;13.8.2019;17:00;247;134;113
utorok;13.8.2019;18:00;240;138;102
utorok;13.8.2019;19:00;226;107;119
utorok;13.8.2019;20:00;116;50;66
utorok;13.8.2019;21:00;22;12;10
utorok;13.8.2019;22:00;10;4;6
utorok;13.8.2019;23:00;13;12;1
streda;14.8.2019;0:00;2;1;1
streda;14.8.2019;1:00;3;1;2
streda;14.8.2019;2:00;0;0;0
streda;14.8.2019;3:00;0;0;0
streda;14.8.2019;4:00;0;0;0
streda;14.8.2019;5:00;3;1;2
streda;14.8.2019;6:00;15;7;8
streda;14.8.2019;7:00;35;16;19
streda;14.8.2019;8:00;83;44;39
streda;14.8.2019;9:00;62;27;35
streda;14.8.2019;10:00;45;20;25
streda;14.8.2019;11:00;52;24;28
streda;14.8.2019;12:00;54;25;29
streda;14.8.2019;13:00;64;26;38
streda;14.8.2019;14:00;93;53;40
streda;14.8.2019;15:00;68;28;40
streda;14.8.2019;16:00;148;78;70
streda;14.8.2019;17:00;204;118;86
streda;14.8.2019;18:00;171;102;69
streda;14.8.2019;19:00;166;74;92
streda;14.8.2019;20:00;97;47;50
streda;14.8.2019;21:00;26;13;13
streda;14.8.2019;22:00;16;8;8
streda;14.8.2019;23:00;3;2;1
štvrtok;15.8.2019;0:00;5;2;3
štvrtok;15.8.2019;1:00;0;0;0
štvrtok;15.8.2019;2:00;0;0;0
štvrtok;15.8.2019;3:00;0;0;0
štvrtok;15.8.2019;4:00;1;1;0
štvrtok;15.8.2019;5:00;14;10;4
štvrtok;15.8.2019;6:00;49;27;22
štvrtok;15.8.2019;7:00;87;36;51
štvrtok;15.8.2019;8:00;125;67;58
štvrtok;15.8.2019;9:00;109;47;62
štvrtok;15.8.2019;10:00;95;48;47
štvrtok;15.8.2019;11:00;122;72;50
štvrtok;15.8.2019;12:00;80;51;29
štvrtok;15.8.2019;13:00;95;52;43
štvrtok;15.8.2019;14:00;132;66;66
štvrtok;15.8.2019;15:00;170;90;80
štvrtok;15.8.2019;16:00;214;124;90
štvrtok;15.8.2019;17:00;377;237;140
štvrtok;15.8.2019;18:00;324;186;138
štvrtok;15.8.2019;19:00;274;120;154
štvrtok;15.8.2019;20:00;129;78;51
štvrtok;15.8.2019;21:00;43;23;20
štvrtok;15.8.2019;22:00;21;12;9
štvrtok;15.8.2019;23:00;6;4;2
piatok;16.8.2019;0:00;2;1;1
piatok;16.8.2019;1:00;6;6;0
piatok;16.8.2019;2:00;1;0;1
piatok;16.8.2019;3:00;1;0;1
piatok;16.8.2019;4:00;0;0;0
piatok;16.8.2019;5:00;12;5;7
piatok;16.8.2019;6:00;39;25;14
piatok;16.8.2019;7:00;68;33;35
piatok;16.8.2019;8:00;94;48;46
piatok;16.8.2019;9:00;61;34;27
piatok;16.8.2019;10:00;72;31;41
piatok;16.8.2019;11:00;59;25;34
piatok;16.8.2019;12:00;40;15;25
piatok;16.8.2019;13:00;56;29;27
piatok;16.8.2019;14:00;54;29;25
piatok;16.8.2019;15:00;93;45;48
piatok;16.8.2019;16:00;111;69;42
piatok;16.8.2019;17:00;111;46;65
piatok;16.8.2019;18:00;154;79;75
piatok;16.8.2019;19:00;117;63;54
piatok;16.8.2019;20:00;65;29;36
piatok;16.8.2019;21:00;28;17;11
piatok;16.8.2019;22:00;13;9;4
piatok;16.8.2019;23:00;5;3;2
sobota;17.8.2019;0:00;5;1;4
sobota;17.8.2019;1:00;6;4;2
sobota;17.8.2019;2:00;0;0;0
sobota;17.8.2019;3:00;1;1;0
sobota;17.8.2019;4:00;0;0;0
sobota;17.8.2019;5:00;2;2;0
sobota;17.8.2019;6:00;8;6;2
sobota;17.8.2019;7:00;44;24;20
sobota;17.8.2019;8:00;70;45;25
sobota;17.8.2019;9:00;150;98;52
sobota;17.8.2019;10:00;240;169;71
sobota;17.8.2019;11:00;223;127;96
sobota;17.8.2019;12:00;213;114;99
sobota;17.8.2019;13:00;215;129;86
sobota;17.8.2019;14:00;224;123;101
sobota;17.8.2019;15:00;229;107;122
sobota;17.8.2019;16:00;286;144;142
sobota;17.8.2019;17:00;253;95;158
sobota;17.8.2019;18:00;203;101;102
sobota;17.8.2019;19:00;161;80;81
sobota;17.8.2019;20:00;92;53;39
sobota;17.8.2019;21:00;16;6;10
sobota;17.8.2019;22:00;18;12;6
sobota;17.8.2019;23:00;8;2;6
nedeľa;18.8.2019;0:00;10;3;7
nedeľa;18.8.2019;1:00;3;1;2
nedeľa;18.8.2019;2:00;0;0;0
nedeľa;18.8.2019;3:00;0;0;0
nedeľa;18.8.2019;4:00;0;0;0
nedeľa;18.8.2019;5:00;2;2;0
nedeľa;18.8.2019;6:00;19;13;6
nedeľa;18.8.2019;7:00;30;22;8
nedeľa;18.8.2019;8:00;52;41;11
nedeľa;18.8.2019;9:00;148;62;86
nedeľa;18.8.2019;10:00;198;118;80
nedeľa;18.8.2019;11:00;246;127;119
nedeľa;18.8.2019;12:00;180;102;78
nedeľa;18.8.2019;13:00;198;79;119
nedeľa;18.8.2019;14:00;228;121;107
nedeľa;18.8.2019;15:00;215;109;106
nedeľa;18.8.2019;16:00;216;111;105
nedeľa;18.8.2019;17:00;264;142;122
nedeľa;18.8.2019;18:00;233;134;99
nedeľa;18.8.2019;19:00;177;93;84
nedeľa;18.8.2019;20:00;104;55;49
nedeľa;18.8.2019;21:00;21;15;6
nedeľa;18.8.2019;22:00;8;5;3
nedeľa;18.8.2019;23:00;14;5;9
pondelok;19.8.2019;0:00;0;0;0
pondelok;19.8.2019;1:00;1;0;1
pondelok;19.8.2019;2:00;0;0;0
pondelok;19.8.2019;3:00;0;0;0
pondelok;19.8.2019;4:00;1;1;0
pondelok;19.8.2019;5:00;15;7;8
pondelok;19.8.2019;6:00;36;17;19
pondelok;19.8.2019;7:00;92;46;46
pondelok;19.8.2019;8:00;98;48;50
pondelok;19.8.2019;9:00;91;39;52
pondelok;19.8.2019;10:00;91;50;41
pondelok;19.8.2019;11:00;75;31;44
pondelok;19.8.2019;12:00;76;31;45
pondelok;19.8.2019;13:00;66;39;27
pondelok;19.8.2019;14:00;87;35;52
pondelok;19.8.2019;15:00;115;67;48
pondelok;19.8.2019;16:00;198;94;104
pondelok;19.8.2019;17:00;260;156;104
pondelok;19.8.2019;18:00;252;140;112
pondelok;19.8.2019;19:00;226;124;102
pondelok;19.8.2019;20:00;111;79;32
pondelok;19.8.2019;21:00;39;23;16
pondelok;19.8.2019;22:00;22;13;9
pondelok;19.8.2019;23:00;5;3;2
utorok;20.8.2019;0:00;7;1;6
utorok;20.8.2019;1:00;0;0;0
utorok;20.8.2019;2:00;2;1;1
utorok;20.8.2019;3:00;0;0;0
utorok;20.8.2019;4:00;4;3;1
utorok;20.8.2019;5:00;15;6;9
utorok;20.8.2019;6:00;76;49;27
utorok;20.8.2019;7:00;115;59;56
utorok;20.8.2019;8:00;140;63;77
utorok;20.8.2019;9:00;131;55;76
utorok;20.8.2019;10:00;85;40;45
utorok;20.8.2019;11:00;87;33;54
utorok;20.8.2019;12:00;63;35;28
utorok;20.8.2019;13:00;62;29;33
utorok;20.8.2019;14:00;71;38;33
utorok;20.8.2019;15:00;131;63;68
utorok;20.8.2019;16:00;226;128;98
utorok;20.8.2019;17:00;340;207;133
utorok;20.8.2019;18:00;306;176;130
utorok;20.8.2019;19:00;324;157;167
utorok;20.8.2019;20:00;130;66;64
utorok;20.8.2019;21:00;56;23;33
utorok;20.8.2019;22:00;29;20;9
utorok;20.8.2019;23:00;11;9;2
streda;21.8.2019;0:00;2;1;1
streda;21.8.2019;1:00;2;1;1
streda;21.8.2019;2:00;0;0;0
streda;21.8.2019;3:00;0;0;0
streda;21.8.2019;4:00;1;1;0
streda;21.8.2019;5:00;5;1;4
streda;21.8.2019;6:00;18;8;10
streda;21.8.2019;7:00;39;18;21
streda;21.8.2019;8:00;106;62;44
streda;21.8.2019;9:00;62;21;41
streda;21.8.2019;10:00;62;28;34
streda;21.8.2019;11:00;42;26;16
streda;21.8.2019;12:00;43;18;25
streda;21.8.2019;13:00;41;20;21
streda;21.8.2019;14:00;45;16;29
streda;21.8.2019;15:00;71;26;45
streda;21.8.2019;16:00;109;61;48
streda;21.8.2019;17:00;141;89;52
streda;21.8.2019;18:00;105;58;47
streda;21.8.2019;19:00;84;41;43
streda;21.8.2019;20:00;46;29;17
streda;21.8.2019;21:00;15;7;8
streda;21.8.2019;22:00;8;4;4
streda;21.8.2019;23:00;4;4;0
štvrtok;22.8.2019;0:00;1;0;1
štvrtok;22.8.2019;1:00;1;0;1
štvrtok;22.8.2019;2:00;1;1;0
štvrtok;22.8.2019;3:00;0;0;0
štvrtok;22.8.2019;4:00;3;2;1
štvrtok;22.8.2019;5:00;4;3;1
štvrtok;22.8.2019;6:00;33;19;14
štvrtok;22.8.2019;7:00;66;32;34
štvrtok;22.8.2019;8:00;77;44;33
štvrtok;22.8.2019;9:00;52;13;39
štvrtok;22.8.2019;10:00;53;37;16
štvrtok;22.8.2019;11:00;46;22;24
štvrtok;22.8.2019;12:00;38;15;23
štvrtok;22.8.2019;13:00;54;29;25
štvrtok;22.8.2019;14:00;69;37;32
štvrtok;22.8.2019;15:00;123;49;74
štvrtok;22.8.2019;16:00;157;104;53
štvrtok;22.8.2019;17:00;281;157;124
štvrtok;22.8.2019;18:00;167;92;75
štvrtok;22.8.2019;19:00;137;62;75
štvrtok;22.8.2019;20:00;74;45;29
štvrtok;22.8.2019;21:00;27;19;8
štvrtok;22.8.2019;22:00;15;4;11
štvrtok;22.8.2019;23:00;7;4;3
piatok;23.8.2019;0:00;5;3;2
piatok;23.8.2019;1:00;3;2;1
piatok;23.8.2019;2:00;0;0;0
piatok;23.8.2019;3:00;0;0;0
piatok;23.8.2019;4:00;2;2;0
piatok;23.8.2019;5:00;6;4;2
piatok;23.8.2019;6:00;26;16;10
piatok;23.8.2019;7:00;59;25;34
piatok;23.8.2019;8:00;105;58;47
piatok;23.8.2019;9:00;79;30;49
piatok;23.8.2019;10:00;52;27;25
piatok;23.8.2019;11:00;62;32;30
piatok;23.8.2019;12:00;57;34;23
piatok;23.8.2019;13:00;63;31;32
piatok;23.8.2019;14:00;112;67;45
piatok;23.8.2019;15:00;148;81;67
piatok;23.8.2019;16:00;203;100;103
piatok;23.8.2019;17:00;214;105;109
piatok;23.8.2019;18:00;211;110;101
piatok;23.8.2019;19:00;167;86;81
piatok;23.8.2019;20:00;67;39;28
piatok;23.8.2019;21:00;125;104;21
piatok;23.8.2019;22:00;48;12;36
piatok;23.8.2019;23:00;11;6;5
sobota;24.8.2019;0:00;7;6;1
sobota;24.8.2019;1:00;5;0;5
sobota;24.8.2019;2:00;2;0;2
sobota;24.8.2019;3:00;0;0;0
sobota;24.8.2019;4:00;3;1;2
sobota;24.8.2019;5:00;2;1;1
sobota;24.8.2019;6:00;11;9;2
sobota;24.8.2019;7:00;35;26;9
sobota;24.8.2019;8:00;71;41;30
sobota;24.8.2019;9:00;159;96;63
sobota;24.8.2019;10:00;226;150;76
sobota;24.8.2019;11:00;183;102;81
sobota;24.8.2019;12:00;175;87;88
sobota;24.8.2019;13:00;194;94;100
sobota;24.8.2019;14:00;204;106;98
sobota;24.8.2019;15:00;190;92;98
sobota;24.8.2019;16:00;186;108;78
sobota;24.8.2019;17:00;197;78;119
sobota;24.8.2019;18:00;186;95;91
sobota;24.8.2019;19:00;130;68;62
sobota;24.8.2019;20:00;66;26;40
sobota;24.8.2019;21:00;22;10;12
sobota;24.8.2019;22:00;18;9;9
sobota;24.8.2019;23:00;13;9;4
nedeľa;25.8.2019;0:00;5;3;2
nedeľa;25.8.2019;1:00;1;1;0
nedeľa;25.8.2019;2:00;0;0;0
nedeľa;25.8.2019;3:00;1;0;1
nedeľa;25.8.2019;4:00;0;0;0
nedeľa;25.8.2019;5:00;0;0;0
nedeľa;25.8.2019;6:00;3;3;0
nedeľa;25.8.2019;7:00;6;4;2
nedeľa;25.8.2019;8:00;1;0;1
nedeľa;25.8.2019;9:00;4;1;3
nedeľa;25.8.2019;10:00;38;19;19
nedeľa;25.8.2019;11:00;56;32;24
nedeľa;25.8.2019;12:00;92;66;26
nedeľa;25.8.2019;13:00;167;95;72
nedeľa;25.8.2019;14:00;167;95;72
nedeľa;25.8.2019;15:00;209;120;89
nedeľa;25.8.2019;16:00;226;107;119
nedeľa;25.8.2019;17:00;231;123;108
nedeľa;25.8.2019;18:00;250;114;136
nedeľa;25.8.2019;19:00;118;64;54
nedeľa;25.8.2019;20:00;58;39;19
nedeľa;25.8.2019;21:00;22;12;10
nedeľa;25.8.2019;22:00;3;2;1
nedeľa;25.8.2019;23:00;5;5;0
pondelok;26.8.2019;0:00;1;0;1
pondelok;26.8.2019;1:00;1;1;0
pondelok;26.8.2019;2:00;0;0;0
pondelok;26.8.2019;3:00;1;0;1
pondelok;26.8.2019;4:00;1;1;0
pondelok;26.8.2019;5:00;7;1;6
pondelok;26.8.2019;6:00;32;21;11
pondelok;26.8.2019;7:00;77;44;33
pondelok;26.8.2019;8:00;95;44;51
pondelok;26.8.2019;9:00;70;33;37
pondelok;26.8.2019;10:00;44;18;26
pondelok;26.8.2019;11:00;49;23;26
pondelok;26.8.2019;12:00;34;14;20
pondelok;26.8.2019;13:00;39;32;7
pondelok;26.8.2019;14:00;32;16;16
pondelok;26.8.2019;15:00;84;36;48
pondelok;26.8.2019;16:00;130;54;76
pondelok;26.8.2019;17:00;170;102;68
pondelok;26.8.2019;18:00;192;102;90
pondelok;26.8.2019;19:00;127;57;70
pondelok;26.8.2019;20:00;58;30;28
pondelok;26.8.2019;21:00;7;4;3
pondelok;26.8.2019;22:00;9;5;4
pondelok;26.8.2019;23:00;3;2;1
utorok;27.8.2019;0:00;0;0;0
utorok;27.8.2019;1:00;2;0;2
utorok;27.8.2019;2:00;0;0;0
utorok;27.8.2019;3:00;0;0;0
utorok;27.8.2019;4:00;2;2;0
utorok;27.8.2019;5:00;15;6;9
utorok;27.8.2019;6:00;55;41;14
utorok;27.8.2019;7:00;101;53;48
utorok;27.8.2019;8:00;105;47;58
utorok;27.8.2019;9:00;90;43;47
utorok;27.8.2019;10:00;129;78;51
utorok;27.8.2019;11:00;76;38;38
utorok;27.8.2019;12:00;79;45;34
utorok;27.8.2019;13:00;97;43;54
utorok;27.8.2019;14:00;119;41;78
utorok;27.8.2019;15:00;131;68;63
utorok;27.8.2019;16:00;192;109;83
utorok;27.8.2019;17:00;310;187;123
utorok;27.8.2019;18:00;310;169;141
utorok;27.8.2019;19:00;233;110;123
utorok;27.8.2019;20:00;76;38;38
utorok;27.8.2019;21:00;33;20;13
utorok;27.8.2019;22:00;11;5;6
utorok;27.8.2019;23:00;4;2;2
streda;28.8.2019;0:00;5;3;2
streda;28.8.2019;1:00;0;0;0
streda;28.8.2019;2:00;1;0;1
streda;28.8.2019;3:00;0;0;0
streda;28.8.2019;4:00;0;0;0
streda;28.8.2019;5:00;12;4;8
streda;28.8.2019;6:00;37;28;9
streda;28.8.2019;7:00;77;42;35
streda;28.8.2019;8:00;95;50;45
streda;28.8.2019;9:00;100;51;49
streda;28.8.2019;10:00;95;51;44
streda;28.8.2019;11:00;64;30;34
streda;28.8.2019;12:00;66;37;29
streda;28.8.2019;13:00;49;26;23
streda;28.8.2019;14:00;70;43;27
streda;28.8.2019;15:00;122;69;53
streda;28.8.2019;16:00;175;89;86
streda;28.8.2019;17:00;185;102;83
streda;28.8.2019;18:00;187;109;78
streda;28.8.2019;19:00;137;66;71
streda;28.8.2019;20:00;60;27;33
streda;28.8.2019;21:00;21;16;5
streda;28.8.2019;22:00;18;15;3
streda;28.8.2019;23:00;18;6;12
štvrtok;29.8.2019;0:00;2;2;0
štvrtok;29.8.2019;1:00;5;1;4
štvrtok;29.8.2019;2:00;3;0;3
štvrtok;29.8.2019;3:00;0;0;0
štvrtok;29.8.2019;4:00;1;1;0
štvrtok;29.8.2019;5:00;2;2;0
štvrtok;29.8.2019;6:00;21;16;5
štvrtok;29.8.2019;7:00;50;36;14
štvrtok;29.8.2019;8:00;119;83;36
štvrtok;29.8.2019;9:00;204;122;82
štvrtok;29.8.2019;10:00;242;174;68
štvrtok;29.8.2019;11:00;227;138;89
štvrtok;29.8.2019;12:00;165;81;84
štvrtok;29.8.2019;13:00;183;110;73
štvrtok;29.8.2019;14:00;183;89;94
štvrtok;29.8.2019;15:00;191;114;77
štvrtok;29.8.2019;16:00;196;94;102
štvrtok;29.8.2019;17:00;276;147;129
štvrtok;29.8.2019;18:00;232;99;133
štvrtok;29.8.2019;19:00;172;80;92
štvrtok;29.8.2019;20:00;61;38;23
štvrtok;29.8.2019;21:00;14;9;5
štvrtok;29.8.2019;22:00;7;4;3
štvrtok;29.8.2019;23:00;3;3;0
piatok;30.8.2019;0:00;3;0;3
piatok;30.8.2019;1:00;0;0;0
piatok;30.8.2019;2:00;2;2;0
piatok;30.8.2019;3:00;0;0;0
piatok;30.8.2019;4:00;1;1;0
piatok;30.8.2019;5:00;5;4;1
piatok;30.8.2019;6:00;28;15;13
piatok;30.8.2019;7:00;37;25;12
piatok;30.8.2019;8:00;62;37;25
piatok;30.8.2019;9:00;73;38;35
piatok;30.8.2019;10:00;97;59;38
piatok;30.8.2019;11:00;107;67;40
piatok;30.8.2019;12:00;74;37;37
piatok;30.8.2019;13:00;99;44;55
piatok;30.8.2019;14:00;86;39;47
piatok;30.8.2019;15:00;110;64;46
piatok;30.8.2019;16:00;121;66;55
piatok;30.8.2019;17:00;173;84;89
piatok;30.8.2019;18:00;177;92;85
piatok;30.8.2019;19:00;139;69;70
piatok;30.8.2019;20:00;43;29;14
piatok;30.8.2019;21:00;18;12;6
piatok;30.8.2019;22:00;24;18;6
piatok;30.8.2019;23:00;4;2;2
sobota;31.8.2019;0:00;8;6;2
sobota;31.8.2019;1:00;3;2;1
sobota;31.8.2019;2:00;1;1;0
sobota;31.8.2019;3:00;2;2;0
sobota;31.8.2019;4:00;1;0;1
sobota;31.8.2019;5:00;3;2;1
sobota;31.8.2019;6:00;12;6;6
sobota;31.8.2019;7:00;34;18;16
sobota;31.8.2019;8:00;68;39;29
sobota;31.8.2019;9:00;128;75;53
sobota;31.8.2019;10:00;141;88;53
sobota;31.8.2019;11:00;133;80;53
sobota;31.8.2019;12:00;122;71;51
sobota;31.8.2019;13:00;126;67;59
sobota;31.8.2019;14:00;140;67;73
sobota;31.8.2019;15:00;147;64;83
sobota;31.8.2019;16:00;115;61;54
sobota;31.8.2019;17:00;162;73;89
sobota;31.8.2019;18:00;159;82;77
sobota;31.8.2019;19:00;150;76;74
sobota;31.8.2019;20:00;62;34;28
sobota;31.8.2019;21:00;22;10;12
sobota;31.8.2019;22:00;12;8;4
sobota;31.8.2019;23:00;11;7;4
nedeľa;1.9.2019;0:00;5;2;3
nedeľa;1.9.2019;1:00;2;2;0
nedeľa;1.9.2019;2:00;1;0;1
nedeľa;1.9.2019;3:00;0;0;0
nedeľa;1.9.2019;4:00;0;0;0
nedeľa;1.9.2019;5:00;7;5;2
nedeľa;1.9.2019;6:00;16;13;3
nedeľa;1.9.2019;7:00;40;29;11
nedeľa;1.9.2019;8:00;69;40;29
nedeľa;1.9.2019;9:00;146;80;66
nedeľa;1.9.2019;10:00;193;126;67
nedeľa;1.9.2019;11:00;201;97;104
nedeľa;1.9.2019;12:00;181;103;78
nedeľa;1.9.2019;13:00;169;94;75
nedeľa;1.9.2019;14:00;200;87;113
nedeľa;1.9.2019;15:00;224;109;115
nedeľa;1.9.2019;16:00;204;109;95
nedeľa;1.9.2019;17:00;220;131;89
nedeľa;1.9.2019;18:00;183;96;87
nedeľa;1.9.2019;19:00;119;71;48
nedeľa;1.9.2019;20:00;53;38;15
nedeľa;1.9.2019;21:00;10;8;2
nedeľa;1.9.2019;22:00;7;6;1
nedeľa;1.9.2019;23:00;3;2;1
pondelok;2.9.2019;0:00;3;1;2
pondelok;2.9.2019;1:00;2;2;0
pondelok;2.9.2019;2:00;0;0;0
pondelok;2.9.2019;3:00;1;1;0
pondelok;2.9.2019;4:00;0;0;0
pondelok;2.9.2019;5:00;7;3;4
pondelok;2.9.2019;6:00;12;8;4
pondelok;2.9.2019;7:00;25;10;15
pondelok;2.9.2019;8:00;49;18;31
pondelok;2.9.2019;9:00;60;13;47
pondelok;2.9.2019;10:00;32;11;21
pondelok;2.9.2019;11:00;17;3;14
pondelok;2.9.2019;12:00;19;5;14
pondelok;2.9.2019;13:00;19;12;7
pondelok;2.9.2019;14:00;21;11;10
pondelok;2.9.2019;15:00;45;24;21
pondelok;2.9.2019;16:00;50;30;20
pondelok;2.9.2019;17:00;60;37;23
pondelok;2.9.2019;18:00;54;29;25
pondelok;2.9.2019;19:00;27;12;15
pondelok;2.9.2019;20:00;8;5;3
pondelok;2.9.2019;21:00;6;4;2
pondelok;2.9.2019;22:00;2;2;0
pondelok;2.9.2019;23:00;3;0;3
utorok;3.9.2019;0:00;0;0;0
utorok;3.9.2019;1:00;0;0;0
utorok;3.9.2019;2:00;0;0;0
utorok;3.9.2019;3:00;0;0;0
utorok;3.9.2019;4:00;0;0;0
utorok;3.9.2019;5:00;7;2;5
utorok;3.9.2019;6:00;23;17;6
utorok;3.9.2019;7:00;68;31;37
utorok;3.9.2019;8:00;105;46;59
utorok;3.9.2019;9:00;52;21;31
utorok;3.9.2019;10:00;42;25;17
utorok;3.9.2019;11:00;42;22;20
utorok;3.9.2019;12:00;50;26;24
utorok;3.9.2019;13:00;38;19;19
utorok;3.9.2019;14:00;67;33;34
utorok;3.9.2019;15:00;86;38;48
utorok;3.9.2019;16:00;167;101;66
utorok;3.9.2019;17:00;275;158;117
utorok;3.9.2019;18:00;209;124;85
utorok;3.9.2019;19:00;192;83;109
utorok;3.9.2019;20:00;53;32;21
utorok;3.9.2019;21:00;19;13;6
utorok;3.9.2019;22:00;11;4;7
utorok;3.9.2019;23:00;2;1;1
streda;4.9.2019;0:00;1;0;1
streda;4.9.2019;1:00;0;0;0
streda;4.9.2019;2:00;0;0;0
streda;4.9.2019;3:00;1;1;0
streda;4.9.2019;4:00;1;1;0
streda;4.9.2019;5:00;11;6;5
streda;4.9.2019;6:00;32;20;12
streda;4.9.2019;7:00;77;37;40
streda;4.9.2019;8:00;132;69;63
streda;4.9.2019;9:00;91;40;51
streda;4.9.2019;10:00;72;47;25
streda;4.9.2019;11:00;74;31;43
streda;4.9.2019;12:00;102;45;57
streda;4.9.2019;13:00;103;33;70
streda;4.9.2019;14:00;89;36;53
streda;4.9.2019;15:00;152;99;53
streda;4.9.2019;16:00;246;148;98
streda;4.9.2019;17:00;315;190;125
streda;4.9.2019;18:00;289;159;130
streda;4.9.2019;19:00;188;92;96
streda;4.9.2019;20:00;77;31;46
streda;4.9.2019;21:00;18;7;11
streda;4.9.2019;22:00;12;8;4
streda;4.9.2019;23:00;11;3;8
štvrtok;5.9.2019;0:00;1;0;1
štvrtok;5.9.2019;1:00;3;1;2
štvrtok;5.9.2019;2:00;1;1;0
štvrtok;5.9.2019;3:00;0;0;0
štvrtok;5.9.2019;4:00;4;2;2
štvrtok;5.9.2019;5:00;9;4;5
štvrtok;5.9.2019;6:00;41;19;22
štvrtok;5.9.2019;7:00;94;51;43
štvrtok;5.9.2019;8:00;133;55;78
štvrtok;5.9.2019;9:00;91;54;37
štvrtok;5.9.2019;10:00;79;51;28
štvrtok;5.9.2019;11:00;56;19;37
štvrtok;5.9.2019;12:00;66;33;33
štvrtok;5.9.2019;13:00;77;44;33
štvrtok;5.9.2019;14:00;95;65;30
štvrtok;5.9.2019;15:00;178;103;75
štvrtok;5.9.2019;16:00;264;150;114
štvrtok;5.9.2019;17:00;382;228;154
štvrtok;5.9.2019;18:00;306;170;136
štvrtok;5.9.2019;19:00;218;109;109
štvrtok;5.9.2019;20:00;82;33;49
štvrtok;5.9.2019;21:00;31;17;14
štvrtok;5.9.2019;22:00;16;12;4
štvrtok;5.9.2019;23:00;10;9;1
piatok;6.9.2019;0:00;8;8;0
piatok;6.9.2019;1:00;6;4;2
piatok;6.9.2019;2:00;0;0;0
piatok;6.9.2019;3:00;0;0;0
piatok;6.9.2019;4:00;0;0;0
piatok;6.9.2019;5:00;4;2;2
piatok;6.9.2019;6:00;31;21;10
piatok;6.9.2019;7:00;47;22;25
piatok;6.9.2019;8:00;80;33;47
piatok;6.9.2019;9:00;53;32;21
piatok;6.9.2019;10:00;43;19;24
piatok;6.9.2019;11:00;47;23;24
piatok;6.9.2019;12:00;31;20;11
piatok;6.9.2019;13:00;52;33;19
piatok;6.9.2019;14:00;72;40;32
piatok;6.9.2019;15:00;90;55;35
piatok;6.9.2019;16:00;50;23;27
piatok;6.9.2019;17:00;37;23;14
piatok;6.9.2019;18:00;24;10;14
piatok;6.9.2019;19:00;13;4;9
piatok;6.9.2019;20:00;8;5;3
piatok;6.9.2019;21:00;11;3;8
piatok;6.9.2019;22:00;3;3;0
piatok;6.9.2019;23:00;6;2;4
sobota;7.9.2019;0:00;3;3;0
sobota;7.9.2019;1:00;1;0;1
sobota;7.9.2019;2:00;0;0;0
sobota;7.9.2019;3:00;0;0;0
sobota;7.9.2019;4:00;0;0;0
sobota;7.9.2019;5:00;0;0;0
sobota;7.9.2019;6:00;1;1;0
sobota;7.9.2019;7:00;3;2;1
sobota;7.9.2019;8:00;5;3;2
sobota;7.9.2019;9:00;6;1;5
sobota;7.9.2019;10:00;12;3;9
sobota;7.9.2019;11:00;14;7;7
sobota;7.9.2019;12:00;19;9;10
sobota;7.9.2019;13:00;24;14;10
sobota;7.9.2019;14:00;38;19;19
sobota;7.9.2019;15:00;36;19;17
sobota;7.9.2019;16:00;53;27;26
sobota;7.9.2019;17:00;36;23;13
sobota;7.9.2019;18:00;23;9;14
sobota;7.9.2019;19:00;7;3;4
sobota;7.9.2019;20:00;5;0;5
sobota;7.9.2019;21:00;9;3;6
sobota;7.9.2019;22:00;2;2;0
sobota;7.9.2019;23:00;1;0;1
nedeľa;8.9.2019;0:00;1;0;1
nedeľa;8.9.2019;1:00;0;0;0
nedeľa;8.9.2019;2:00;3;2;1
nedeľa;8.9.2019;3:00;3;1;2
nedeľa;8.9.2019;4:00;3;0;3
nedeľa;8.9.2019;5:00;0;0;0
nedeľa;8.9.2019;6:00;2;2;0
nedeľa;8.9.2019;7:00;2;0;2
nedeľa;8.9.2019;8:00;8;4;4
nedeľa;8.9.2019;9:00;34;12;22
nedeľa;8.9.2019;10:00;36;18;18
nedeľa;8.9.2019;11:00;80;54;26
nedeľa;8.9.2019;12:00;122;80;42
nedeľa;8.9.2019;13:00;102;69;33
nedeľa;8.9.2019;14:00;158;89;69
nedeľa;8.9.2019;15:00;164;90;74
nedeľa;8.9.2019;16:00;207;108;99
nedeľa;8.9.2019;17:00;176;91;85
nedeľa;8.9.2019;18:00;136;69;67
nedeľa;8.9.2019;19:00;52;26;26
nedeľa;8.9.2019;20:00;18;13;5
nedeľa;8.9.2019;21:00;14;8;6
nedeľa;8.9.2019;22:00;2;2;0
nedeľa;8.9.2019;23:00;4;0;4
pondelok;9.9.2019;0:00;0;0;0
pondelok;9.9.2019;1:00;0;0;0
pondelok;9.9.2019;2:00;0;0;0
pondelok;9.9.2019;3:00;0;0;0
pondelok;9.9.2019;4:00;0;0;0
pondelok;9.9.2019;5:00;2;2;0
pondelok;9.9.2019;6:00;3;3;0
pondelok;9.9.2019;7:00;11;5;6
pondelok;9.9.2019;8:00;24;11;13
pondelok;9.9.2019;9:00;32;3;29
pondelok;9.9.2019;10:00;21;2;19
pondelok;9.9.2019;11:00;25;9;16
pondelok;9.9.2019;12:00;28;16;12
pondelok;9.9.2019;13:00;19;11;8
pondelok;9.9.2019;14:00;18;5;13
pondelok;9.9.2019;15:00;18;8;10
pondelok;9.9.2019;16:00;47;28;19
pondelok;9.9.2019;17:00;59;32;27
pondelok;9.9.2019;18:00;65;34;31
pondelok;9.9.2019;19:00;51;29;22
pondelok;9.9.2019;20:00;22;10;12
pondelok;9.9.2019;21:00;6;6;0
pondelok;9.9.2019;22:00;3;2;1
pondelok;9.9.2019;23:00;5;2;3
utorok;10.9.2019;0:00;0;0;0
utorok;10.9.2019;1:00;0;0;0
utorok;10.9.2019;2:00;0;0;0
utorok;10.9.2019;3:00;0;0;0
utorok;10.9.2019;4:00;1;0;1
utorok;10.9.2019;5:00;6;2;4
utorok;10.9.2019;6:00;36;16;20
utorok;10.9.2019;7:00;60;28;32
utorok;10.9.2019;8:00;88;41;47
utorok;10.9.2019;9:00;64;14;50
utorok;10.9.2019;10:00;57;34;23
utorok;10.9.2019;11:00;83;53;30
utorok;10.9.2019;12:00;56;23;33
utorok;10.9.2019;13:00;55;25;30
utorok;10.9.2019;14:00;60;27;33
utorok;10.9.2019;15:00;110;62;48
utorok;10.9.2019;16:00;177;94;83
utorok;10.9.2019;17:00;251;147;104
utorok;10.9.2019;18:00;187;97;90
utorok;10.9.2019;19:00;114;54;60
utorok;10.9.2019;20:00;31;12;19
utorok;10.9.2019;21:00;18;8;10
utorok;10.9.2019;22:00;14;9;5
utorok;10.9.2019;23:00;1;1;0
streda;11.9.2019;0:00;1;1;0
streda;11.9.2019;1:00;0;0;0
streda;11.9.2019;2:00;1;0;1
streda;11.9.2019;3:00;0;0;0
streda;11.9.2019;4:00;1;1;0
streda;11.9.2019;5:00;11;5;6
streda;11.9.2019;6:00;32;19;13
streda;11.9.2019;7:00;69;33;36
streda;11.9.2019;8:00;104;47;57
streda;11.9.2019;9:00;77;37;40
streda;11.9.2019;10:00;67;21;46
streda;11.9.2019;11:00;61;27;34
streda;11.9.2019;12:00;53;30;23
streda;11.9.2019;13:00;84;50;34
streda;11.9.2019;14:00;94;62;32
streda;11.9.2019;15:00;162;88;74
streda;11.9.2019;16:00;271;163;108
streda;11.9.2019;17:00;299;189;110
streda;11.9.2019;18:00;261;139;122
streda;11.9.2019;19:00;172;84;88
streda;11.9.2019;20:00;51;26;25
streda;11.9.2019;21:00;23;13;10
streda;11.9.2019;22:00;8;4;4
streda;11.9.2019;23:00;5;3;2
štvrtok;12.9.2019;0:00;2;1;1
štvrtok;12.9.2019;1:00;0;0;0
štvrtok;12.9.2019;2:00;0;0;0
štvrtok;12.9.2019;3:00;0;0;0
štvrtok;12.9.2019;4:00;1;1;0
štvrtok;12.9.2019;5:00;10;5;5
štvrtok;12.9.2019;6:00;41;22;19
štvrtok;12.9.2019;7:00;74;38;36
štvrtok;12.9.2019;8:00;109;39;70
štvrtok;12.9.2019;9:00;82;42;40
štvrtok;12.9.2019;10:00;67;43;24
štvrtok;12.9.2019;11:00;80;39;41
štvrtok;12.9.2019;12:00;59;34;25
štvrtok;12.9.2019;13:00;88;31;57
štvrtok;12.9.2019;14:00;93;52;41
štvrtok;12.9.2019;15:00;135;72;63
štvrtok;12.9.2019;16:00;216;114;102
štvrtok;12.9.2019;17:00;334;206;128
štvrtok;12.9.2019;18:00;227;130;97
štvrtok;12.9.2019;19:00;164;61;103
štvrtok;12.9.2019;20:00;36;19;17
štvrtok;12.9.2019;21:00;17;8;9
štvrtok;12.9.2019;22:00;9;6;3
štvrtok;12.9.2019;23:00;6;2;4
piatok;13.9.2019;0:00;0;0;0
piatok;13.9.2019;1:00;1;1;0
piatok;13.9.2019;2:00;0;0;0
piatok;13.9.2019;3:00;1;1;0
piatok;13.9.2019;4:00;1;1;0
piatok;13.9.2019;5:00;8;4;4
piatok;13.9.2019;6:00;30;16;14
piatok;13.9.2019;7:00;58;27;31
piatok;13.9.2019;8:00;111;54;57
piatok;13.9.2019;9:00;64;21;43
piatok;13.9.2019;10:00;60;35;25
piatok;13.9.2019;11:00;77;44;33
piatok;13.9.2019;12:00;63;28;35
piatok;13.9.2019;13:00;63;36;27
piatok;13.9.2019;14:00;120;69;51
piatok;13.9.2019;15:00;167;85;82
piatok;13.9.2019;16:00;201;108;93
piatok;13.9.2019;17:00;208;101;107
piatok;13.9.2019;18:00;181;105;76
piatok;13.9.2019;19:00;90;42;48
piatok;13.9.2019;20:00;27;14;13
piatok;13.9.2019;21:00;14;6;8
piatok;13.9.2019;22:00;5;3;2
piatok;13.9.2019;23:00;9;8;1
sobota;14.9.2019;0:00;6;5;1
sobota;14.9.2019;1:00;1;0;1
sobota;14.9.2019;2:00;1;1;0
sobota;14.9.2019;3:00;1;0;1
sobota;14.9.2019;4:00;0;0;0
sobota;14.9.2019;5:00;3;3;0
sobota;14.9.2019;6:00;12;10;2
sobota;14.9.2019;7:00;23;19;4
sobota;14.9.2019;8:00;74;49;25
sobota;14.9.2019;9:00;115;80;35
sobota;14.9.2019;10:00;143;86;57
sobota;14.9.2019;11:00;193;121;72
sobota;14.9.2019;12:00;199;118;81
sobota;14.9.2019;13:00;153;76;77
sobota;14.9.2019;14:00;196;99;97
sobota;14.9.2019;15:00;191;90;101
sobota;14.9.2019;16:00;166;87;79
sobota;14.9.2019;17:00;202;95;107
sobota;14.9.2019;18:00;158;87;71
sobota;14.9.2019;19:00;104;48;56
sobota;14.9.2019;20:00;22;13;9
sobota;14.9.2019;21:00;6;3;3
sobota;14.9.2019;22:00;9;2;7
sobota;14.9.2019;23:00;3;2;1
nedeľa;15.9.2019;0:00;4;2;2
nedeľa;15.9.2019;1:00;2;1;1
nedeľa;15.9.2019;2:00;1;1;0
nedeľa;15.9.2019;3:00;2;0;2
nedeľa;15.9.2019;4:00;2;0;2
nedeľa;15.9.2019;5:00;6;5;1
nedeľa;15.9.2019;6:00;13;11;2
nedeľa;15.9.2019;7:00;25;13;12
nedeľa;15.9.2019;8:00;45;29;16
nedeľa;15.9.2019;9:00;108;61;47
nedeľa;15.9.2019;10:00;175;114;61
nedeľa;15.9.2019;11:00;205;114;91
nedeľa;15.9.2019;12:00;208;120;88
nedeľa;15.9.2019;13:00;210;122;88
nedeľa;15.9.2019;14:00;274;152;122
nedeľa;15.9.2019;15:00;304;144;160
nedeľa;15.9.2019;16:00;316;155;161
nedeľa;15.9.2019;17:00;330;148;182
nedeľa;15.9.2019;18:00;282;130;152
nedeľa;15.9.2019;19:00;98;59;39
nedeľa;15.9.2019;20:00;18;7;11
nedeľa;15.9.2019;21:00;11;7;4
nedeľa;15.9.2019;22:00;23;2;21
nedeľa;15.9.2019;23:00;8;1;7
pondelok;16.9.2019;0:00;0;0;0
pondelok;16.9.2019;1:00;2;0;2
pondelok;16.9.2019;2:00;1;1;0
pondelok;16.9.2019;3:00;0;0;0
pondelok;16.9.2019;4:00;0;0;0
pondelok;16.9.2019;5:00;11;5;6
pondelok;16.9.2019;6:00;36;25;11
pondelok;16.9.2019;7:00;64;34;30
pondelok;16.9.2019;8:00;106;45;61
pondelok;16.9.2019;9:00;69;24;45
pondelok;16.9.2019;10:00;68;28;40
pondelok;16.9.2019;11:00;68;38;30
pondelok;16.9.2019;12:00;59;36;23
pondelok;16.9.2019;13:00;65;34;31
pondelok;16.9.2019;14:00;92;50;42
pondelok;16.9.2019;15:00;135;71;64
pondelok;16.9.2019;16:00;185;104;81
pondelok;16.9.2019;17:00;289;168;121
pondelok;16.9.2019;18:00;228;127;101
pondelok;16.9.2019;19:00;95;46;49
pondelok;16.9.2019;20:00;46;31;15
pondelok;16.9.2019;21:00;15;9;6
pondelok;16.9.2019;22:00;9;3;6
pondelok;16.9.2019;23:00;6;1;5
utorok;17.9.2019;0:00;2;2;0
utorok;17.9.2019;1:00;0;0;0
utorok;17.9.2019;2:00;0;0;0
utorok;17.9.2019;3:00;1;0;1
utorok;17.9.2019;4:00;1;0;1
utorok;17.9.2019;5:00;12;7;5
utorok;17.9.2019;6:00;49;32;17
utorok;17.9.2019;7:00;72;30;42
utorok;17.9.2019;8:00;110;47;63
utorok;17.9.2019;9:00;67;24;43
utorok;17.9.2019;10:00;65;49;16
utorok;17.9.2019;11:00;49;17;32
utorok;17.9.2019;12:00;42;17;25
utorok;17.9.2019;13:00;32;15;17
utorok;17.9.2019;14:00;59;29;30
utorok;17.9.2019;15:00;76;39;37
utorok;17.9.2019;16:00;121;67;54
utorok;17.9.2019;17:00;199;120;79
utorok;17.9.2019;18:00;125;62;63
utorok;17.9.2019;19:00;83;39;44
utorok;17.9.2019;20:00;19;10;9
utorok;17.9.2019;21:00;7;6;1
utorok;17.9.2019;22:00;12;8;4
utorok;17.9.2019;23:00;3;2;1
streda;18.9.2019;0:00;0;0;0
streda;18.9.2019;1:00;1;0;1
streda;18.9.2019;2:00;1;1;0
streda;18.9.2019;3:00;0;0;0
streda;18.9.2019;4:00;1;0;1
streda;18.9.2019;5:00;11;4;7
streda;18.9.2019;6:00;29;21;8
streda;18.9.2019;7:00;51;23;28
streda;18.9.2019;8:00;114;44;70
streda;18.9.2019;9:00;51;22;29
streda;18.9.2019;10:00;43;18;25
streda;18.9.2019;11:00;33;11;22
streda;18.9.2019;12:00;32;17;15
streda;18.9.2019;13:00;49;32;17
streda;18.9.2019;14:00;63;35;28
streda;18.9.2019;15:00;108;65;43
streda;18.9.2019;16:00;166;88;78
streda;18.9.2019;17:00;207;106;101
streda;18.9.2019;18:00;170;79;91
streda;18.9.2019;19:00;80;43;37
streda;18.9.2019;20:00;16;8;8
streda;18.9.2019;21:00;8;7;1
streda;18.9.2019;22:00;4;2;2
streda;18.9.2019;23:00;4;1;3
štvrtok;19.9.2019;0:00;1;1;0
štvrtok;19.9.2019;1:00;1;0;1
štvrtok;19.9.2019;2:00;0;0;0
štvrtok;19.9.2019;3:00;0;0;0
štvrtok;19.9.2019;4:00;1;1;0
štvrtok;19.9.2019;5:00;4;2;2
štvrtok;19.9.2019;6:00;28;16;12
štvrtok;19.9.2019;7:00;53;30;23
štvrtok;19.9.2019;8:00;74;31;43
štvrtok;19.9.2019;9:00;48;26;22
štvrtok;19.9.2019;10:00;42;29;13
štvrtok;19.9.2019;11:00;37;15;22
štvrtok;19.9.2019;12:00;43;22;21
štvrtok;19.9.2019;13:00;34;20;14
štvrtok;19.9.2019;14:00;66;32;34
štvrtok;19.9.2019;15:00;99;58;41
štvrtok;19.9.2019;16:00;139;82;57
štvrtok;19.9.2019;17:00;190;114;76
štvrtok;19.9.2019;18:00;102;59;43
štvrtok;19.9.2019;19:00;39;27;12
štvrtok;19.9.2019;20:00;19;6;13
štvrtok;19.9.2019;21:00;11;9;2
štvrtok;19.9.2019;22:00;5;4;1
štvrtok;19.9.2019;23:00;4;3;1
piatok;20.9.2019;0:00;0;0;0
piatok;20.9.2019;1:00;1;0;1
piatok;20.9.2019;2:00;1;0;1
piatok;20.9.2019;3:00;0;0;0
piatok;20.9.2019;4:00;2;1;1
piatok;20.9.2019;5:00;6;3;3
piatok;20.9.2019;6:00;20;14;6
piatok;20.9.2019;7:00;41;13;28
piatok;20.9.2019;8:00;71;37;34
piatok;20.9.2019;9:00;26;21;5
piatok;20.9.2019;10:00;32;16;16
piatok;20.9.2019;11:00;31;15;16
piatok;20.9.2019;12:00;34;20;14
piatok;20.9.2019;13:00;60;36;24
piatok;20.9.2019;14:00;70;36;34
piatok;20.9.2019;15:00;100;59;41
piatok;20.9.2019;16:00;132;72;60
piatok;20.9.2019;17:00;140;74;66
piatok;20.9.2019;18:00;98;54;44
piatok;20.9.2019;19:00;45;19;26
piatok;20.9.2019;20:00;17;9;8
piatok;20.9.2019;21:00;12;6;6
piatok;20.9.2019;22:00;8;3;5
piatok;20.9.2019;23:00;0;0;0
sobota;21.9.2019;0:00;0;0;0
sobota;21.9.2019;1:00;3;2;1
sobota;21.9.2019;2:00;0;0;0
sobota;21.9.2019;3:00;0;0;0
sobota;21.9.2019;4:00;2;1;1
sobota;21.9.2019;5:00;2;1;1
sobota;21.9.2019;6:00;9;7;2
sobota;21.9.2019;7:00;10;6;4
sobota;21.9.2019;8:00;54;28;26
sobota;21.9.2019;9:00;72;56;16
sobota;21.9.2019;10:00;84;63;21
sobota;21.9.2019;11:00;166;98;68
sobota;21.9.2019;12:00;147;96;51
sobota;21.9.2019;13:00;173;107;66
sobota;21.9.2019;14:00;282;192;90
sobota;21.9.2019;15:00;202;107;95
sobota;21.9.2019;16:00;225;71;154
sobota;21.9.2019;17:00;204;99;105
sobota;21.9.2019;18:00;168;93;75
sobota;21.9.2019;19:00;60;33;27
sobota;21.9.2019;20:00;19;12;7
sobota;21.9.2019;21:00;12;7;5
sobota;21.9.2019;22:00;10;7;3
sobota;21.9.2019;23:00;2;1;1
nedeľa;22.9.2019;0:00;3;3;0
nedeľa;22.9.2019;1:00;5;4;1
nedeľa;22.9.2019;2:00;1;0;1
nedeľa;22.9.2019;3:00;3;2;1
nedeľa;22.9.2019;4:00;0;0;0
nedeľa;22.9.2019;5:00;5;4;1
nedeľa;22.9.2019;6:00;5;5;0
nedeľa;22.9.2019;7:00;13;8;5
nedeľa;22.9.2019;8:00;39;25;14
nedeľa;22.9.2019;9:00;55;37;18
nedeľa;22.9.2019;10:00;160;89;71
nedeľa;22.9.2019;11:00;191;127;64
nedeľa;22.9.2019;12:00;154;84;70
nedeľa;22.9.2019;13:00;184;78;106
nedeľa;22.9.2019;14:00;201;120;81
nedeľa;22.9.2019;15:00;235;137;98
nedeľa;22.9.2019;16:00;221;101;120
nedeľa;22.9.2019;17:00;209;66;143
nedeľa;22.9.2019;18:00;127;49;78
nedeľa;22.9.2019;19:00;39;21;18
nedeľa;22.9.2019;20:00;15;8;7
nedeľa;22.9.2019;21:00;14;4;10
nedeľa;22.9.2019;22:00;7;3;4
nedeľa;22.9.2019;23:00;4;2;2
pondelok;23.9.2019;0:00;1;0;1
pondelok;23.9.2019;1:00;0;0;0
pondelok;23.9.2019;2:00;0;0;0
pondelok;23.9.2019;3:00;0;0;0
pondelok;23.9.2019;4:00;1;1;0
pondelok;23.9.2019;5:00;5;2;3
pondelok;23.9.2019;6:00;23;12;11
pondelok;23.9.2019;7:00;46;26;20
pondelok;23.9.2019;8:00;76;31;45
pondelok;23.9.2019;9:00;68;22;46
pondelok;23.9.2019;10:00;34;16;18
pondelok;23.9.2019;11:00;43;16;27
pondelok;23.9.2019;12:00;36;14;22
pondelok;23.9.2019;13:00;42;27;15
pondelok;23.9.2019;14:00;49;27;22
pondelok;23.9.2019;15:00;68;31;37
pondelok;23.9.2019;16:00;107;62;45
pondelok;23.9.2019;17:00;155;86;69
pondelok;23.9.2019;18:00;98;53;45
pondelok;23.9.2019;19:00;41;24;17
pondelok;23.9.2019;20:00;19;11;8
pondelok;23.9.2019;21:00;7;3;4
pondelok;23.9.2019;22:00;1;1;0
pondelok;23.9.2019;23:00;1;0;1
utorok;24.9.2019;0:00;0;0;0
utorok;24.9.2019;1:00;1;0;1
utorok;24.9.2019;2:00;0;0;0
utorok;24.9.2019;3:00;0;0;0
utorok;24.9.2019;4:00;0;0;0
utorok;24.9.2019;5:00;15;6;9
utorok;24.9.2019;6:00;31;20;11
utorok;24.9.2019;7:00;66;25;41
utorok;24.9.2019;8:00;94;48;46
utorok;24.9.2019;9:00;47;25;22
utorok;24.9.2019;10:00;46;30;16
utorok;24.9.2019;11:00;49;29;20
utorok;24.9.2019;12:00;41;15;26
utorok;24.9.2019;13:00;46;21;25
utorok;24.9.2019;14:00;74;44;30
utorok;24.9.2019;15:00;120;67;53
utorok;24.9.2019;16:00;156;79;77
utorok;24.9.2019;17:00;221;126;95
utorok;24.9.2019;18:00;163;89;74
utorok;24.9.2019;19:00;86;45;41
utorok;24.9.2019;20:00;19;8;11
utorok;24.9.2019;21:00;8;5;3
utorok;24.9.2019;22:00;9;8;1
utorok;24.9.2019;23:00;5;1;4
streda;25.9.2019;0:00;2;2;0
streda;25.9.2019;1:00;1;0;1
streda;25.9.2019;2:00;0;0;0
streda;25.9.2019;3:00;0;0;0
streda;25.9.2019;4:00;0;0;0
streda;25.9.2019;5:00;9;4;5
streda;25.9.2019;6:00;34;20;14
streda;25.9.2019;7:00;58;24;34
streda;25.9.2019;8:00;90;40;50
streda;25.9.2019;9:00;49;29;20
streda;25.9.2019;10:00;29;13;16
streda;25.9.2019;11:00;38;10;28
streda;25.9.2019;12:00;36;19;17
streda;25.9.2019;13:00;46;25;21
streda;25.9.2019;14:00;46;21;25
streda;25.9.2019;15:00;110;65;45
streda;25.9.2019;16:00;119;75;44
streda;25.9.2019;17:00;170;91;79
streda;25.9.2019;18:00;93;49;44
streda;25.9.2019;19:00;62;33;29
streda;25.9.2019;20:00;16;10;6
streda;25.9.2019;21:00;9;6;3
streda;25.9.2019;22:00;4;3;1
streda;25.9.2019;23:00;0;0;0
štvrtok;26.9.2019;0:00;3;2;1
štvrtok;26.9.2019;1:00;0;0;0
štvrtok;26.9.2019;2:00;0;0;0
štvrtok;26.9.2019;3:00;0;0;0
štvrtok;26.9.2019;4:00;0;0;0
štvrtok;26.9.2019;5:00;7;2;5
štvrtok;26.9.2019;6:00;31;20;11
štvrtok;26.9.2019;7:00;56;27;29
štvrtok;26.9.2019;8:00;97;42;55
štvrtok;26.9.2019;9:00;54;26;28
štvrtok;26.9.2019;10:00;71;39;32
štvrtok;26.9.2019;11:00;53;32;21
štvrtok;26.9.2019;12:00;56;30;26
štvrtok;26.9.2019;13:00;61;37;24
štvrtok;26.9.2019;14:00;88;41;47
štvrtok;26.9.2019;15:00;111;49;62
štvrtok;26.9.2019;16:00;149;87;62
štvrtok;26.9.2019;17:00;215;134;81
štvrtok;26.9.2019;18:00;136;67;69
štvrtok;26.9.2019;19:00;60;30;30
štvrtok;26.9.2019;20:00;12;8;4
štvrtok;26.9.2019;21:00;12;6;6
štvrtok;26.9.2019;22:00;3;0;3
štvrtok;26.9.2019;23:00;1;0;1
piatok;27.9.2019;0:00;3;0;3
piatok;27.9.2019;1:00;1;1;0
piatok;27.9.2019;2:00;2;0;2
piatok;27.9.2019;3:00;0;0;0
piatok;27.9.2019;4:00;0;0;0
piatok;27.9.2019;5:00;5;3;2
piatok;27.9.2019;6:00;29;17;12
piatok;27.9.2019;7:00;44;19;25
piatok;27.9.2019;8:00;62;29;33
piatok;27.9.2019;9:00;64;29;35
piatok;27.9.2019;10:00;54;38;16
piatok;27.9.2019;11:00;39;22;17
piatok;27.9.2019;12:00;47;25;22
piatok;27.9.2019;13:00;56;31;25
piatok;27.9.2019;14:00;76;49;27
piatok;27.9.2019;15:00;110;63;47
piatok;27.9.2019;16:00;133;74;59
piatok;27.9.2019;17:00;130;79;51
piatok;27.9.2019;18:00;114;53;61
piatok;27.9.2019;19:00;50;25;25
piatok;27.9.2019;20:00;41;19;22
piatok;27.9.2019;21:00;23;13;10
piatok;27.9.2019;22:00;24;13;11
piatok;27.9.2019;23:00;17;8;9
sobota;28.9.2019;0:00;5;4;1
sobota;28.9.2019;1:00;5;5;0
sobota;28.9.2019;2:00;2;0;2
sobota;28.9.2019;3:00;0;0;0
sobota;28.9.2019;4:00;1;0;1
sobota;28.9.2019;5:00;1;0;1
sobota;28.9.2019;6:00;5;4;1
sobota;28.9.2019;7:00;13;6;7
sobota;28.9.2019;8:00;18;11;7
sobota;28.9.2019;9:00;18;10;8
sobota;28.9.2019;10:00;15;7;8
sobota;28.9.2019;11:00;21;11;10
sobota;28.9.2019;12:00;22;5;17
sobota;28.9.2019;13:00;16;6;10
sobota;28.9.2019;14:00;18;10;8
sobota;28.9.2019;15:00;21;7;14
sobota;28.9.2019;16:00;58;17;41
sobota;28.9.2019;17:00;18;6;12
sobota;28.9.2019;18:00;20;11;9
sobota;28.9.2019;19:00;14;6;8
sobota;28.9.2019;20:00;29;8;21
sobota;28.9.2019;21:00;15;5;10
sobota;28.9.2019;22:00;16;3;13
sobota;28.9.2019;23:00;7;1;6
nedeľa;29.9.2019;0:00;6;3;3
nedeľa;29.9.2019;1:00;0;0;0
nedeľa;29.9.2019;2:00;1;1;0
nedeľa;29.9.2019;3:00;0;0;0
nedeľa;29.9.2019;4:00;1;0;1
nedeľa;29.9.2019;5:00;2;0;2
nedeľa;29.9.2019;6:00;3;2;1
nedeľa;29.9.2019;7:00;9;7;2
nedeľa;29.9.2019;8:00;34;26;8
nedeľa;29.9.2019;9:00;64;44;20
nedeľa;29.9.2019;10:00;118;80;38
nedeľa;29.9.2019;11:00;172;103;69
nedeľa;29.9.2019;12:00;190;105;85
nedeľa;29.9.2019;13:00;198;120;78
nedeľa;29.9.2019;14:00;219;129;90
nedeľa;29.9.2019;15:00;283;154;129
nedeľa;29.9.2019;16:00;247;113;134
nedeľa;29.9.2019;17:00;229;108;121
nedeľa;29.9.2019;18:00;147;77;70
nedeľa;29.9.2019;19:00;45;24;21
nedeľa;29.9.2019;20:00;25;14;11
nedeľa;29.9.2019;21:00;11;5;6
nedeľa;29.9.2019;22:00;9;6;3
nedeľa;29.9.2019;23:00;5;1;4
pondelok;30.9.2019;0:00;2;0;2
pondelok;30.9.2019;1:00;0;0;0
pondelok;30.9.2019;2:00;1;0;1
pondelok;30.9.2019;3:00;0;0;0
pondelok;30.9.2019;4:00;1;0;1
pondelok;30.9.2019;5:00;2;0;2
pondelok;30.9.2019;6:00;14;8;6
pondelok;30.9.2019;7:00;50;27;23
pondelok;30.9.2019;8:00;73;36;37
pondelok;30.9.2019;9:00;59;22;37
pondelok;30.9.2019;10:00;27;9;18
pondelok;30.9.2019;11:00;25;9;16
pondelok;30.9.2019;12:00;21;12;9
pondelok;30.9.2019;13:00;20;7;13
pondelok;30.9.2019;14:00;33;13;20
pondelok;30.9.2019;15:00;35;18;17
pondelok;30.9.2019;16:00;76;40;36
pondelok;30.9.2019;17:00;92;44;48
pondelok;30.9.2019;18:00;64;38;26
pondelok;30.9.2019;19:00;34;19;15
pondelok;30.9.2019;20:00;13;8;5
pondelok;30.9.2019;21:00;13;6;7
pondelok;30.9.2019;22:00;2;1;1
pondelok;30.9.2019;23:00;4;3;1
utorok;1.10.2019;0:00;1;0;1
utorok;1.10.2019;1:00;1;1;0
utorok;1.10.2019;2:00;1;0;1
utorok;1.10.2019;3:00;0;0;0
utorok;1.10.2019;4:00;1;1;0
utorok;1.10.2019;5:00;4;3;1
utorok;1.10.2019;6:00;34;21;13
utorok;1.10.2019;7:00;81;47;34
utorok;1.10.2019;8:00;89;37;52
utorok;1.10.2019;9:00;56;28;28
utorok;1.10.2019;10:00;86;60;26
utorok;1.10.2019;11:00;51;25;26
utorok;1.10.2019;12:00;59;21;38
utorok;1.10.2019;13:00;55;39;16
utorok;1.10.2019;14:00;78;40;38
utorok;1.10.2019;15:00;127;76;51
utorok;1.10.2019;16:00;223;110;113
utorok;1.10.2019;17:00;265;170;95
utorok;1.10.2019;18:00;177;98;79
utorok;1.10.2019;19:00;78;33;45
utorok;1.10.2019;20:00;28;10;18
utorok;1.10.2019;21:00;16;7;9
utorok;1.10.2019;22:00;9;4;5
utorok;1.10.2019;23:00;3;1;2
streda;2.10.2019;0:00;1;0;1
streda;2.10.2019;1:00;0;0;0
streda;2.10.2019;2:00;0;0;0
streda;2.10.2019;3:00;0;0;0
streda;2.10.2019;4:00;0;0;0
streda;2.10.2019;5:00;6;2;4
streda;2.10.2019;6:00;21;11;10
streda;2.10.2019;7:00;48;25;23
streda;2.10.2019;8:00;73;30;43
streda;2.10.2019;9:00;54;24;30
streda;2.10.2019;10:00;46;21;25
streda;2.10.2019;11:00;37;21;16
streda;2.10.2019;12:00;43;19;24
streda;2.10.2019;13:00;13;8;5
streda;2.10.2019;14:00;14;8;6
streda;2.10.2019;15:00;25;12;13
streda;2.10.2019;16:00;47;31;16
streda;2.10.2019;17:00;25;16;9
streda;2.10.2019;18:00;11;5;6
streda;2.10.2019;19:00;6;3;3
streda;2.10.2019;20:00;8;2;6
streda;2.10.2019;21:00;4;2;2
streda;2.10.2019;22:00;3;2;1
streda;2.10.2019;23:00;0;0;0
štvrtok;3.10.2019;0:00;0;0;0
štvrtok;3.10.2019;1:00;0;0;0
štvrtok;3.10.2019;2:00;0;0;0
štvrtok;3.10.2019;3:00;0;0;0
štvrtok;3.10.2019;4:00;0;0;0
štvrtok;3.10.2019;5:00;3;1;2
štvrtok;3.10.2019;6:00;12;10;2
štvrtok;3.10.2019;7:00;42;14;28
štvrtok;3.10.2019;8:00;50;27;23
štvrtok;3.10.2019;9:00;22;12;10
štvrtok;3.10.2019;10:00;29;16;13
štvrtok;3.10.2019;11:00;21;15;6
štvrtok;3.10.2019;12:00;17;7;10
štvrtok;3.10.2019;13:00;24;8;16
štvrtok;3.10.2019;14:00;25;10;15
štvrtok;3.10.2019;15:00;62;35;27
štvrtok;3.10.2019;16:00;67;39;28
štvrtok;3.10.2019;17:00;120;75;45
štvrtok;3.10.2019;18:00;64;28;36
štvrtok;3.10.2019;19:00;37;15;22
štvrtok;3.10.2019;20:00;11;8;3
štvrtok;3.10.2019;21:00;10;3;7
štvrtok;3.10.2019;22:00;2;1;1
štvrtok;3.10.2019;23:00;3;1;2
piatok;4.10.2019;0:00;7;5;2
piatok;4.10.2019;1:00;1;0;1
piatok;4.10.2019;2:00;0;0;0
piatok;4.10.2019;3:00;0;0;0
piatok;4.10.2019;4:00;0;0;0
piatok;4.10.2019;5:00;5;4;1
piatok;4.10.2019;6:00;19;11;8
piatok;4.10.2019;7:00;41;20;21
piatok;4.10.2019;8:00;42;20;22
piatok;4.10.2019;9:00;50;27;23
piatok;4.10.2019;10:00;32;20;12
piatok;4.10.2019;11:00;23;9;14
piatok;4.10.2019;12:00;37;15;22
piatok;4.10.2019;13:00;45;14;31
piatok;4.10.2019;14:00;38;13;25
piatok;4.10.2019;15:00;101;61;40
piatok;4.10.2019;16:00;128;67;61
piatok;4.10.2019;17:00;120;69;51
piatok;4.10.2019;18:00;80;39;41
piatok;4.10.2019;19:00;28;15;13
piatok;4.10.2019;20:00;19;9;10
piatok;4.10.2019;21:00;8;5;3
piatok;4.10.2019;22:00;10;3;7
piatok;4.10.2019;23:00;1;1;0
sobota;5.10.2019;0:00;2;1;1
sobota;5.10.2019;1:00;0;0;0
sobota;5.10.2019;2:00;1;0;1
sobota;5.10.2019;3:00;0;0;0
sobota;5.10.2019;4:00;0;0;0
sobota;5.10.2019;5:00;1;1;0
sobota;5.10.2019;6:00;2;2;0
sobota;5.10.2019;7:00;7;6;1
sobota;5.10.2019;8:00;8;5;3
sobota;5.10.2019;9:00;4;1;3
sobota;5.10.2019;10:00;18;9;9
sobota;5.10.2019;11:00;11;3;8
sobota;5.10.2019;12:00;6;3;3
sobota;5.10.2019;13:00;8;5;3
sobota;5.10.2019;14:00;8;3;5
sobota;5.10.2019;15:00;8;2;6
sobota;5.10.2019;16:00;14;2;12
sobota;5.10.2019;17:00;20;3;17
sobota;5.10.2019;18:00;22;7;15
sobota;5.10.2019;19:00;15;4;11
sobota;5.10.2019;20:00;7;1;6
sobota;5.10.2019;21:00;1;0;1
sobota;5.10.2019;22:00;1;1;0
sobota;5.10.2019;23:00;1;0;1
nedeľa;6.10.2019;0:00;0;0;0
nedeľa;6.10.2019;1:00;0;0;0
nedeľa;6.10.2019;2:00;0;0;0
nedeľa;6.10.2019;3:00;0;0;0
nedeľa;6.10.2019;4:00;0;0;0
nedeľa;6.10.2019;5:00;0;0;0
nedeľa;6.10.2019;6:00;2;2;0
nedeľa;6.10.2019;7:00;7;5;2
nedeľa;6.10.2019;8:00;12;10;2
nedeľa;6.10.2019;9:00;86;65;21
nedeľa;6.10.2019;10:00;142;113;29
nedeľa;6.10.2019;11:00;81;50;31
nedeľa;6.10.2019;12:00;132;44;88
nedeľa;6.10.2019;13:00;102;43;59
nedeľa;6.10.2019;14:00;114;56;58
nedeľa;6.10.2019;15:00;127;49;78
nedeľa;6.10.2019;16:00;106;48;58
nedeľa;6.10.2019;17:00;94;47;47
nedeľa;6.10.2019;18:00;33;16;17
nedeľa;6.10.2019;19:00;15;9;6
nedeľa;6.10.2019;20:00;1;0;1
nedeľa;6.10.2019;21:00;5;3;2
nedeľa;6.10.2019;22:00;3;2;1
nedeľa;6.10.2019;23:00;1;1;0
pondelok;7.10.2019;0:00;0;0;0
pondelok;7.10.2019;1:00;0;0;0
pondelok;7.10.2019;2:00;0;0;0
pondelok;7.10.2019;3:00;0;0;0
pondelok;7.10.2019;4:00;1;1;0
pondelok;7.10.2019;5:00;1;1;0
pondelok;7.10.2019;6:00;10;7;3
pondelok;7.10.2019;7:00;39;16;23
pondelok;7.10.2019;8:00;67;35;32
pondelok;7.10.2019;9:00;35;12;23
pondelok;7.10.2019;10:00;21;12;9
pondelok;7.10.2019;11:00;22;12;10
pondelok;7.10.2019;12:00;28;15;13
pondelok;7.10.2019;13:00;34;21;13
pondelok;7.10.2019;14:00;33;16;17
pondelok;7.10.2019;15:00;60;31;29
pondelok;7.10.2019;16:00;97;50;47
pondelok;7.10.2019;17:00;104;52;52
pondelok;7.10.2019;18:00;74;37;37
pondelok;7.10.2019;19:00;33;20;13
pondelok;7.10.2019;20:00;13;6;7
pondelok;7.10.2019;21:00;4;2;2
pondelok;7.10.2019;22:00;2;2;0
pondelok;7.10.2019;23:00;0;0;0
utorok;8.10.2019;0:00;0;0;0
utorok;8.10.2019;1:00;1;0;1
utorok;8.10.2019;2:00;0;0;0
utorok;8.10.2019;3:00;0;0;0
utorok;8.10.2019;4:00;0;0;0
utorok;8.10.2019;5:00;5;2;3
utorok;8.10.2019;6:00;17;12;5
utorok;8.10.2019;7:00;37;15;22
utorok;8.10.2019;8:00;53;26;27
utorok;8.10.2019;9:00;33;12;21
utorok;8.10.2019;10:00;37;26;11
utorok;8.10.2019;11:00;22;8;14
utorok;8.10.2019;12:00;24;14;10
utorok;8.10.2019;13:00;20;8;12
utorok;8.10.2019;14:00;34;18;16
utorok;8.10.2019;15:00;71;46;25
utorok;8.10.2019;16:00;97;57;40
utorok;8.10.2019;17:00;118;67;51
utorok;8.10.2019;18:00;48;21;27
utorok;8.10.2019;19:00;28;12;16
utorok;8.10.2019;20:00;11;6;5
utorok;8.10.2019;21:00;7;4;3
utorok;8.10.2019;22:00;7;5;2
utorok;8.10.2019;23:00;2;1;1
streda;9.10.2019;0:00;2;0;2
streda;9.10.2019;1:00;0;0;0
streda;9.10.2019;2:00;0;0;0
streda;9.10.2019;3:00;0;0;0
streda;9.10.2019;4:00;1;1;0
streda;9.10.2019;5:00;2;0;2
streda;9.10.2019;6:00;19;11;8
streda;9.10.2019;7:00;37;20;17
streda;9.10.2019;8:00;65;30;35
streda;9.10.2019;9:00;30;13;17
streda;9.10.2019;10:00;24;13;11
streda;9.10.2019;11:00;29;16;13
streda;9.10.2019;12:00;30;22;8
streda;9.10.2019;13:00;26;12;14
streda;9.10.2019;14:00;39;24;15
streda;9.10.2019;15:00;59;30;29
streda;9.10.2019;16:00;94;52;42
streda;9.10.2019;17:00;124;72;52
streda;9.10.2019;18:00;64;29;35
streda;9.10.2019;19:00;29;11;18
streda;9.10.2019;20:00;5;3;2
streda;9.10.2019;21:00;3;2;1
streda;9.10.2019;22:00;7;4;3
streda;9.10.2019;23:00;0;0;0
štvrtok;10.10.2019;0:00;0;0;0
štvrtok;10.10.2019;1:00;0;0;0
štvrtok;10.10.2019;2:00;0;0;0
štvrtok;10.10.2019;3:00;0;0;0
štvrtok;10.10.2019;4:00;1;0;1
štvrtok;10.10.2019;5:00;6;0;6
štvrtok;10.10.2019;6:00;15;11;4
štvrtok;10.10.2019;7:00;43;20;23
štvrtok;10.10.2019;8:00;57;25;32
štvrtok;10.10.2019;9:00;38;20;18
štvrtok;10.10.2019;10:00;19;11;8
štvrtok;10.10.2019;11:00;30;9;21
štvrtok;10.10.2019;12:00;26;16;10
štvrtok;10.10.2019;13:00;31;16;15
štvrtok;10.10.2019;14:00;39;16;23
štvrtok;10.10.2019;15:00;69;42;27
štvrtok;10.10.2019;16:00;68;37;31
štvrtok;10.10.2019;17:00;98;61;37
štvrtok;10.10.2019;18:00;50;28;22
štvrtok;10.10.2019;19:00;18;10;8
štvrtok;10.10.2019;20:00;12;7;5
štvrtok;10.10.2019;21:00;9;3;6
štvrtok;10.10.2019;22:00;3;2;1
štvrtok;10.10.2019;23:00;0;0;0
piatok;11.10.2019;0:00;1;0;1
piatok;11.10.2019;1:00;0;0;0
piatok;11.10.2019;2:00;0;0;0
piatok;11.10.2019;3:00;0;0;0
piatok;11.10.2019;4:00;0;0;0
piatok;11.10.2019;5:00;4;1;3
piatok;11.10.2019;6:00;14;10;4
piatok;11.10.2019;7:00;36;16;20
piatok;11.10.2019;8:00;61;25;36
piatok;11.10.2019;9:00;39;24;15
piatok;11.10.2019;10:00;33;18;15
piatok;11.10.2019;11:00;53;30;23
piatok;11.10.2019;12:00;42;20;22
piatok;11.10.2019;13:00;74;34;40
piatok;11.10.2019;14:00;83;42;41
piatok;11.10.2019;15:00;102;48;54
piatok;11.10.2019;16:00;159;94;65
piatok;11.10.2019;17:00;123;71;52
piatok;11.10.2019;18:00;70;38;32
piatok;11.10.2019;19:00;27;15;12
piatok;11.10.2019;20:00;10;3;7
piatok;11.10.2019;21:00;6;4;2
piatok;11.10.2019;22:00;6;4;2
piatok;11.10.2019;23:00;4;1;3
sobota;12.10.2019;0:00;1;1;0
sobota;12.10.2019;1:00;2;0;2
sobota;12.10.2019;2:00;1;0;1
sobota;12.10.2019;3:00;0;0;0
sobota;12.10.2019;4:00;0;0;0
sobota;12.10.2019;5:00;1;1;0
sobota;12.10.2019;6:00;2;2;0
sobota;12.10.2019;7:00;2;1;1
sobota;12.10.2019;8:00;12;10;2
sobota;12.10.2019;9:00;31;19;12
sobota;12.10.2019;10:00;62;49;13
sobota;12.10.2019;11:00;100;69;31
sobota;12.10.2019;12:00;99;60;39
sobota;12.10.2019;13:00;69;44;25
sobota;12.10.2019;14:00;103;67;36
sobota;12.10.2019;15:00;99;60;39
sobota;12.10.2019;16:00;119;44;75
sobota;12.10.2019;17:00;150;62;88
sobota;12.10.2019;18:00;53;27;26
sobota;12.10.2019;19:00;35;9;26
sobota;12.10.2019;20:00;10;3;7
sobota;12.10.2019;21:00;8;2;6
sobota;12.10.2019;22:00;12;1;11
sobota;12.10.2019;23:00;4;1;3
nedeľa;13.10.2019;0:00;0;0;0
nedeľa;13.10.2019;1:00;0;0;0
nedeľa;13.10.2019;2:00;2;0;2
nedeľa;13.10.2019;3:00;1;0;1
nedeľa;13.10.2019;4:00;0;0;0
nedeľa;13.10.2019;5:00;3;2;1
nedeľa;13.10.2019;6:00;1;0;1
nedeľa;13.10.2019;7:00;3;3;0
nedeľa;13.10.2019;8:00;24;15;9
nedeľa;13.10.2019;9:00;49;36;13
nedeľa;13.10.2019;10:00;123;90;33
nedeľa;13.10.2019;11:00;125;79;46
nedeľa;13.10.2019;12:00;153;106;47
nedeľa;13.10.2019;13:00;187;104;83
nedeľa;13.10.2019;14:00;217;122;95
nedeľa;13.10.2019;15:00;269;131;138
nedeľa;13.10.2019;16:00;262;116;146
nedeľa;13.10.2019;17:00;153;68;85
nedeľa;13.10.2019;18:00;76;29;47
nedeľa;13.10.2019;19:00;28;12;16
nedeľa;13.10.2019;20:00;4;1;3
nedeľa;13.10.2019;21:00;5;1;4
nedeľa;13.10.2019;22:00;7;3;4
nedeľa;13.10.2019;23:00;1;1;0
pondelok;14.10.2019;0:00;0;0;0
pondelok;14.10.2019;1:00;0;0;0
pondelok;14.10.2019;2:00;0;0;0
pondelok;14.10.2019;3:00;0;0;0
pondelok;14.10.2019;4:00;0;0;0
pondelok;14.10.2019;5:00;6;3;3
pondelok;14.10.2019;6:00;10;4;6
pondelok;14.10.2019;7:00;45;27;18
pondelok;14.10.2019;8:00;77;34;43
pondelok;14.10.2019;9:00;46;30;16
pondelok;14.10.2019;10:00;37;27;10
pondelok;14.10.2019;11:00;70;40;30
pondelok;14.10.2019;12:00;54;25;29
pondelok;14.10.2019;13:00;60;34;26
pondelok;14.10.2019;14:00;72;34;38
pondelok;14.10.2019;15:00;144;73;71
pondelok;14.10.2019;16:00;182;95;87
pondelok;14.10.2019;17:00;190;103;87
pondelok;14.10.2019;18:00;106;54;52
pondelok;14.10.2019;19:00;45;23;22
pondelok;14.10.2019;20:00;15;11;4
pondelok;14.10.2019;21:00;14;6;8
pondelok;14.10.2019;22:00;2;1;1
pondelok;14.10.2019;23:00;1;0;1
utorok;15.10.2019;0:00;0;0;0
utorok;15.10.2019;1:00;0;0;0
utorok;15.10.2019;2:00;0;0;0
utorok;15.10.2019;3:00;0;0;0
utorok;15.10.2019;4:00;1;0;1
utorok;15.10.2019;5:00;6;3;3
utorok;15.10.2019;6:00;19;12;7
utorok;15.10.2019;7:00;51;31;20
utorok;15.10.2019;8:00;72;34;38
utorok;15.10.2019;9:00;42;23;19
utorok;15.10.2019;10:00;64;55;9
utorok;15.10.2019;11:00;45;20;25
utorok;15.10.2019;12:00;53;25;28
utorok;15.10.2019;13:00;47;29;18
utorok;15.10.2019;14:00;71;42;29
utorok;15.10.2019;15:00;116;66;50
utorok;15.10.2019;16:00;186;98;88
utorok;15.10.2019;17:00;211;127;84
utorok;15.10.2019;18:00;120;52;68
utorok;15.10.2019;19:00;37;21;16
utorok;15.10.2019;20:00;12;8;4
utorok;15.10.2019;21:00;10;3;7
utorok;15.10.2019;22:00;7;7;0
utorok;15.10.2019;23:00;5;1;4
streda;16.10.2019;0:00;1;1;0
streda;16.10.2019;1:00;1;1;0
streda;16.10.2019;2:00;0;0;0
streda;16.10.2019;3:00;0;0;0
streda;16.10.2019;4:00;0;0;0
streda;16.10.2019;5:00;3;1;2
streda;16.10.2019;6:00;17;6;11
streda;16.10.2019;7:00;40;23;17
streda;16.10.2019;8:00;50;25;25
streda;16.10.2019;9:00;13;4;9
streda;16.10.2019;10:00;1;1;0
streda;16.10.2019;11:00;9;5;4
streda;16.10.2019;12:00;4;1;3
streda;16.10.2019;13:00;16;8;8
streda;16.10.2019;14:00;23;10;13
streda;16.10.2019;15:00;57;30;27
streda;16.10.2019;16:00;70;41;29
streda;16.10.2019;17:00;96;56;40
streda;16.10.2019;18:00;82;31;51
streda;16.10.2019;19:00;26;14;12
streda;16.10.2019;20:00;14;10;4
streda;16.10.2019;21:00;8;3;5
streda;16.10.2019;22:00;5;3;2
streda;16.10.2019;23:00;2;1;1
štvrtok;17.10.2019;0:00;2;1;1
štvrtok;17.10.2019;1:00;0;0;0
štvrtok;17.10.2019;2:00;0;0;0
štvrtok;17.10.2019;3:00;0;0;0
štvrtok;17.10.2019;4:00;0;0;0
štvrtok;17.10.2019;5:00;3;1;2
štvrtok;17.10.2019;6:00;14;8;6
štvrtok;17.10.2019;7:00;51;29;22
štvrtok;17.10.2019;8:00;68;32;36
štvrtok;17.10.2019;9:00;23;12;11
štvrtok;17.10.2019;10:00;23;14;9
štvrtok;17.10.2019;11:00;23;15;8
štvrtok;17.10.2019;12:00;23;14;9
štvrtok;17.10.2019;13:00;51;31;20
štvrtok;17.10.2019;14:00;83;58;25
štvrtok;17.10.2019;15:00;92;53;39
štvrtok;17.10.2019;16:00;140;82;58
štvrtok;17.10.2019;17:00;202;125;77
štvrtok;17.10.2019;18:00;114;39;75
štvrtok;17.10.2019;19:00;43;25;18
štvrtok;17.10.2019;20:00;18;10;8
štvrtok;17.10.2019;21:00;7;4;3
štvrtok;17.10.2019;22:00;5;1;4
štvrtok;17.10.2019;23:00;3;1;2
piatok;18.10.2019;0:00;4;1;3
piatok;18.10.2019;1:00;1;0;1
piatok;18.10.2019;2:00;1;0;1
piatok;18.10.2019;3:00;0;0;0
piatok;18.10.2019;4:00;1;0;1
piatok;18.10.2019;5:00;10;4;6
piatok;18.10.2019;6:00;20;14;6
piatok;18.10.2019;7:00;40;16;24
piatok;18.10.2019;8:00;55;26;29
piatok;18.10.2019;9:00;33;16;17
piatok;18.10.2019;10:00;13;10;3
piatok;18.10.2019;11:00;24;11;13
piatok;18.10.2019;12:00;19;8;11
piatok;18.10.2019;13:00;37;21;16
piatok;18.10.2019;14:00;49;26;23
piatok;18.10.2019;15:00;77;43;34
piatok;18.10.2019;16:00;86;44;42
piatok;18.10.2019;17:00;97;52;45
piatok;18.10.2019;18:00;47;20;27
piatok;18.10.2019;19:00;20;7;13
piatok;18.10.2019;20:00;10;5;5
piatok;18.10.2019;21:00;7;6;1
piatok;18.10.2019;22:00;8;1;7
piatok;18.10.2019;23:00;5;0;5
sobota;19.10.2019;0:00;4;1;3
sobota;19.10.2019;1:00;1;0;1
sobota;19.10.2019;2:00;0;0;0
sobota;19.10.2019;3:00;0;0;0
sobota;19.10.2019;4:00;3;0;3
sobota;19.10.2019;5:00;2;1;1
sobota;19.10.2019;6:00;4;4;0
sobota;19.10.2019;7:00;6;2;4
sobota;19.10.2019;8:00;16;12;4
sobota;19.10.2019;9:00;46;23;23
sobota;19.10.2019;10:00;50;37;13
sobota;19.10.2019;11:00;53;29;24
sobota;19.10.2019;12:00;63;39;24
sobota;19.10.2019;13:00;76;52;24
sobota;19.10.2019;14:00;90;39;51
sobota;19.10.2019;15:00;112;57;55
sobota;19.10.2019;16:00;127;59;68
sobota;19.10.2019;17:00;132;49;83
sobota;19.10.2019;18:00;57;19;38
sobota;19.10.2019;19:00;15;3;12
sobota;19.10.2019;20:00;10;7;3
sobota;19.10.2019;21:00;7;3;4
sobota;19.10.2019;22:00;1;0;1
sobota;19.10.2019;23:00;3;1;2
nedeľa;20.10.2019;0:00;3;3;0
nedeľa;20.10.2019;1:00;0;0;0
nedeľa;20.10.2019;2:00;0;0;0
nedeľa;20.10.2019;3:00;0;0;0
nedeľa;20.10.2019;4:00;2;1;1
nedeľa;20.10.2019;5:00;1;1;0
nedeľa;20.10.2019;6:00;3;3;0
nedeľa;20.10.2019;7:00;6;6;0
nedeľa;20.10.2019;8:00;17;12;5
nedeľa;20.10.2019;9:00;51;32;19
nedeľa;20.10.2019;10:00;199;160;39
nedeľa;20.10.2019;11:00;170;107;63
nedeľa;20.10.2019;12:00;238;138;100
nedeľa;20.10.2019;13:00;255;146;109
nedeľa;20.10.2019;14:00;298;178;120
nedeľa;20.10.2019;15:00;355;172;183
nedeľa;20.10.2019;16:00;270;124;146
nedeľa;20.10.2019;17:00;216;80;136
nedeľa;20.10.2019;18:00;79;33;46
nedeľa;20.10.2019;19:00;29;18;11
nedeľa;20.10.2019;20:00;15;10;5
nedeľa;20.10.2019;21:00;3;2;1
nedeľa;20.10.2019;22:00;3;1;2
nedeľa;20.10.2019;23:00;0;0;0
pondelok;21.10.2019;0:00;0;0;0
pondelok;21.10.2019;1:00;0;0;0
pondelok;21.10.2019;2:00;0;0;0
pondelok;21.10.2019;3:00;0;0;0
pondelok;21.10.2019;4:00;0;0;0
pondelok;21.10.2019;5:00;11;9;2
pondelok;21.10.2019;6:00;15;6;9
pondelok;21.10.2019;7:00;59;25;34
pondelok;21.10.2019;8:00;90;45;45
pondelok;21.10.2019;9:00;39;22;17
pondelok;21.10.2019;10:00;47;32;15
pondelok;21.10.2019;11:00;50;26;24
pondelok;21.10.2019;12:00;45;20;25
pondelok;21.10.2019;13:00;64;34;30
pondelok;21.10.2019;14:00;108;50;58
pondelok;21.10.2019;15:00;130;68;62
pondelok;21.10.2019;16:00;223;122;101
pondelok;21.10.2019;17:00;246;140;106
pondelok;21.10.2019;18:00;136;71;65
pondelok;21.10.2019;19:00;38;21;17
pondelok;21.10.2019;20:00;19;10;9
pondelok;21.10.2019;21:00;11;5;6
pondelok;21.10.2019;22:00;4;4;0
pondelok;21.10.2019;23:00;1;1;0
utorok;22.10.2019;0:00;0;0;0
utorok;22.10.2019;1:00;0;0;0
utorok;22.10.2019;2:00;0;0;0
utorok;22.10.2019;3:00;2;1;1
utorok;22.10.2019;4:00;0;0;0
utorok;22.10.2019;5:00;9;3;6
utorok;22.10.2019;6:00;31;17;14
utorok;22.10.2019;7:00;53;22;31
utorok;22.10.2019;8:00;70;37;33
utorok;22.10.2019;9:00;40;14;26
utorok;22.10.2019;10:00;60;50;10
utorok;22.10.2019;11:00;57;28;29
utorok;22.10.2019;12:00;60;28;32
utorok;22.10.2019;13:00;67;37;30
utorok;22.10.2019;14:00;87;44;43
utorok;22.10.2019;15:00;154;90;64
utorok;22.10.2019;16:00;194;112;82
utorok;22.10.2019;17:00;239;151;88
utorok;22.10.2019;18:00;123;53;70
utorok;22.10.2019;19:00;37;17;20
utorok;22.10.2019;20:00;11;7;4
utorok;22.10.2019;21:00;13;8;5
utorok;22.10.2019;22:00;8;6;2
utorok;22.10.2019;23:00;3;1;2
streda;23.10.2019;0:00;0;0;0
streda;23.10.2019;1:00;0;0;0
streda;23.10.2019;2:00;0;0;0
streda;23.10.2019;3:00;0;0;0
streda;23.10.2019;4:00;0;0;0
streda;23.10.2019;5:00;8;4;4
streda;23.10.2019;6:00;18;11;7
streda;23.10.2019;7:00;48;27;21
streda;23.10.2019;8:00;86;41;45
streda;23.10.2019;9:00;46;23;23
streda;23.10.2019;10:00;49;31;18
streda;23.10.2019;11:00;50;30;20
streda;23.10.2019;12:00;52;33;19
streda;23.10.2019;13:00;57;24;33
streda;23.10.2019;14:00;103;49;54
streda;23.10.2019;15:00;148;74;74
streda;23.10.2019;16:00;211;125;86
streda;23.10.2019;17:00;208;116;92
streda;23.10.2019;18:00;122;49;73
streda;23.10.2019;19:00;39;22;17
streda;23.10.2019;20:00;16;13;3
streda;23.10.2019;21:00;10;4;6
streda;23.10.2019;22:00;8;6;2
streda;23.10.2019;23:00;3;3;0
štvrtok;24.10.2019;0:00;0;0;0
štvrtok;24.10.2019;1:00;0;0;0
štvrtok;24.10.2019;2:00;0;0;0
štvrtok;24.10.2019;3:00;1;0;1
štvrtok;24.10.2019;4:00;0;0;0
štvrtok;24.10.2019;5:00;7;3;4
štvrtok;24.10.2019;6:00;17;10;7
štvrtok;24.10.2019;7:00;47;22;25
štvrtok;24.10.2019;8:00;89;44;45
štvrtok;24.10.2019;9:00;33;21;12
štvrtok;24.10.2019;10:00;55;32;23
štvrtok;24.10.2019;11:00;48;23;25
štvrtok;24.10.2019;12:00;55;33;22
štvrtok;24.10.2019;13:00;78;43;35
štvrtok;24.10.2019;14:00;100;61;39
štvrtok;24.10.2019;15:00;141;91;50
štvrtok;24.10.2019;16:00;183;94;89
štvrtok;24.10.2019;17:00;198;109;89
štvrtok;24.10.2019;18:00;116;54;62
štvrtok;24.10.2019;19:00;38;27;11
štvrtok;24.10.2019;20:00;19;11;8
štvrtok;24.10.2019;21:00;15;11;4
štvrtok;24.10.2019;22:00;3;2;1
štvrtok;24.10.2019;23:00;1;0;1
piatok;25.10.2019;0:00;2;1;1
piatok;25.10.2019;1:00;0;0;0
piatok;25.10.2019;2:00;1;1;0
piatok;25.10.2019;3:00;1;0;1
piatok;25.10.2019;4:00;1;0;1
piatok;25.10.2019;5:00;4;2;2
piatok;25.10.2019;6:00;23;14;9
piatok;25.10.2019;7:00;52;21;31
piatok;25.10.2019;8:00;70;36;34
piatok;25.10.2019;9:00;53;37;16
piatok;25.10.2019;10:00;49;27;22
piatok;25.10.2019;11:00;52;32;20
piatok;25.10.2019;12:00;60;32;28
piatok;25.10.2019;13:00;64;25;39
piatok;25.10.2019;14:00;96;49;47
piatok;25.10.2019;15:00;171;99;72
piatok;25.10.2019;16:00;148;68;80
piatok;25.10.2019;17:00;137;77;60
piatok;25.10.2019;18:00;80;38;42
piatok;25.10.2019;19:00;42;23;19
piatok;25.10.2019;20:00;17;9;8
piatok;25.10.2019;21:00;12;7;5
piatok;25.10.2019;22:00;7;5;2
piatok;25.10.2019;23:00;7;3;4
sobota;26.10.2019;0:00;5;0;5
sobota;26.10.2019;1:00;7;0;7
sobota;26.10.2019;2:00;1;1;0
sobota;26.10.2019;3:00;0;0;0
sobota;26.10.2019;4:00;1;1;0
sobota;26.10.2019;5:00;4;1;3
sobota;26.10.2019;6:00;5;3;2
sobota;26.10.2019;7:00;7;3;4
sobota;26.10.2019;8:00;18;9;9
sobota;26.10.2019;9:00;55;44;11
sobota;26.10.2019;10:00;93;67;26
sobota;26.10.2019;11:00;105;76;29
sobota;26.10.2019;12:00;116;75;41
sobota;26.10.2019;13:00;161;109;52
sobota;26.10.2019;14:00;241;139;102
sobota;26.10.2019;15:00;219;113;106
sobota;26.10.2019;16:00;265;105;160
sobota;26.10.2019;17:00;162;77;85
sobota;26.10.2019;18:00;89;28;61
sobota;26.10.2019;19:00;43;10;33
sobota;26.10.2019;20:00;14;3;11
sobota;26.10.2019;21:00;5;1;4
sobota;26.10.2019;22:00;13;2;11
sobota;26.10.2019;23:00;0;0;0
nedeľa;27.10.2019;0:00;6;0;6
nedeľa;27.10.2019;1:00;8;0;8
nedeľa;27.10.2019;2:00;0;0;0
nedeľa;27.10.2019;3:00;0;0;0
nedeľa;27.10.2019;4:00;0;0;0
nedeľa;27.10.2019;5:00;5;4;1
nedeľa;27.10.2019;6:00;5;4;1
nedeľa;27.10.2019;7:00;8;5;3
nedeľa;27.10.2019;8:00;48;26;22
nedeľa;27.10.2019;9:00;71;52;19
nedeľa;27.10.2019;10:00;204;150;54
nedeľa;27.10.2019;11:00;166;103;63
nedeľa;27.10.2019;12:00;211;134;77
nedeľa;27.10.2019;13:00;238;125;113
nedeľa;27.10.2019;14:00;338;216;122
nedeľa;27.10.2019;15:00;322;149;173
nedeľa;27.10.2019;16:00;220;85;135
nedeľa;27.10.2019;17:00;94;45;49
nedeľa;27.10.2019;18:00;26;10;16
nedeľa;27.10.2019;19:00;13;2;11
nedeľa;27.10.2019;20:00;9;0;9
nedeľa;27.10.2019;21:00;10;2;8
nedeľa;27.10.2019;22:00;15;2;13
nedeľa;27.10.2019;23:00;3;0;3
pondelok;28.10.2019;0:00;0;0;0
pondelok;28.10.2019;1:00;1;1;0
pondelok;28.10.2019;2:00;0;0;0
pondelok;28.10.2019;3:00;1;0;1
pondelok;28.10.2019;4:00;0;0;0
pondelok;28.10.2019;5:00;6;1;5
pondelok;28.10.2019;6:00;22;14;8
pondelok;28.10.2019;7:00;31;13;18
pondelok;28.10.2019;8:00;36;19;17
pondelok;28.10.2019;9:00;10;3;7
pondelok;28.10.2019;10:00;6;4;2
pondelok;28.10.2019;11:00;11;3;8
pondelok;28.10.2019;12:00;14;5;9
pondelok;28.10.2019;13:00;13;7;6
pondelok;28.10.2019;14:00;28;16;12
pondelok;28.10.2019;15:00;32;13;19
pondelok;28.10.2019;16:00;64;27;37
pondelok;28.10.2019;17:00;67;23;44
pondelok;28.10.2019;18:00;27;12;15
pondelok;28.10.2019;19:00;8;6;2
pondelok;28.10.2019;20:00;11;9;2
pondelok;28.10.2019;21:00;10;2;8
pondelok;28.10.2019;22:00;4;3;1
pondelok;28.10.2019;23:00;1;0;1
utorok;29.10.2019;0:00;0;0;0
utorok;29.10.2019;1:00;0;0;0
utorok;29.10.2019;2:00;0;0;0
utorok;29.10.2019;3:00;0;0;0
utorok;29.10.2019;4:00;0;0;0
utorok;29.10.2019;5:00;2;0;2
utorok;29.10.2019;6:00;17;14;3
utorok;29.10.2019;7:00;34;9;25
utorok;29.10.2019;8:00;32;12;20
utorok;29.10.2019;9:00;9;3;6
utorok;29.10.2019;10:00;11;8;3
utorok;29.10.2019;11:00;9;6;3
utorok;29.10.2019;12:00;12;5;7
utorok;29.10.2019;13:00;12;8;4
utorok;29.10.2019;14:00;25;18;7
utorok;29.10.2019;15:00;32;15;17
utorok;29.10.2019;16:00;55;31;24
utorok;29.10.2019;17:00;38;20;18
utorok;29.10.2019;18:00;37;17;20
utorok;29.10.2019;19:00;13;8;5
utorok;29.10.2019;20:00;3;2;1
utorok;29.10.2019;21:00;7;1;6
utorok;29.10.2019;22:00;3;2;1
utorok;29.10.2019;23:00;3;0;3
streda;30.10.2019;0:00;0;0;0
streda;30.10.2019;1:00;0;0;0
streda;30.10.2019;2:00;0;0;0
streda;30.10.2019;3:00;0;0;0
streda;30.10.2019;4:00;2;0;2
streda;30.10.2019;5:00;1;0;1
streda;30.10.2019;6:00;12;9;3
streda;30.10.2019;7:00;21;9;12
streda;30.10.2019;8:00;44;17;27
streda;30.10.2019;9:00;14;7;7
streda;30.10.2019;10:00;10;7;3
streda;30.10.2019;11:00;9;3;6
streda;30.10.2019;12:00;9;5;4
streda;30.10.2019;13:00;7;3;4
streda;30.10.2019;14:00;16;10;6
streda;30.10.2019;15:00;37;21;16
streda;30.10.2019;16:00;53;28;25
streda;30.10.2019;17:00;49;23;26
streda;30.10.2019;18:00;20;15;5
streda;30.10.2019;19:00;16;8;8
streda;30.10.2019;20:00;3;2;1
streda;30.10.2019;21:00;4;1;3
streda;30.10.2019;22:00;2;2;0
streda;30.10.2019;23:00;1;0;1
štvrtok;31.10.2019;0:00;1;1;0
štvrtok;31.10.2019;1:00;1;1;0
štvrtok;31.10.2019;2:00;0;0;0
štvrtok;31.10.2019;3:00;0;0;0
štvrtok;31.10.2019;4:00;0;0;0
štvrtok;31.10.2019;5:00;4;0;4
štvrtok;31.10.2019;6:00;15;8;7
štvrtok;31.10.2019;7:00;21;7;14
štvrtok;31.10.2019;8:00;29;15;14
štvrtok;31.10.2019;9:00;14;5;9
štvrtok;31.10.2019;10:00;13;6;7
štvrtok;31.10.2019;11:00;12;7;5
štvrtok;31.10.2019;12:00;15;9;6
štvrtok;31.10.2019;13:00;27;13;14
štvrtok;31.10.2019;14:00;33;26;7
štvrtok;31.10.2019;15:00;44;24;20
štvrtok;31.10.2019;16:00;44;21;23
štvrtok;31.10.2019;17:00;27;18;9
štvrtok;31.10.2019;18:00;21;12;9
štvrtok;31.10.2019;19:00;38;32;6
štvrtok;31.10.2019;20:00;6;2;4
štvrtok;31.10.2019;21:00;0;0;0
štvrtok;31.10.2019;22:00;2;1;1
štvrtok;31.10.2019;23:00;2;2;0
piatok;1.11.2019;0:00;0;0;0
piatok;1.11.2019;1:00;0;0;0
piatok;1.11.2019;2:00;0;0;0
piatok;1.11.2019;3:00;1;0;1
piatok;1.11.2019;4:00;0;0;0
piatok;1.11.2019;5:00;0;0;0
piatok;1.11.2019;6:00;7;6;1
piatok;1.11.2019;7:00;6;5;1
piatok;1.11.2019;8:00;9;6;3
piatok;1.11.2019;9:00;13;8;5
piatok;1.11.2019;10:00;43;29;14
piatok;1.11.2019;11:00;49;31;18
piatok;1.11.2019;12:00;61;34;27
piatok;1.11.2019;13:00;56;32;24
piatok;1.11.2019;14:00;55;31;24
piatok;1.11.2019;15:00;42;14;28
piatok;1.11.2019;16:00;36;14;22
piatok;1.11.2019;17:00;19;8;11
piatok;1.11.2019;18:00;5;3;2
piatok;1.11.2019;19:00;4;0;4
piatok;1.11.2019;20:00;3;2;1
piatok;1.11.2019;21:00;1;1;0
piatok;1.11.2019;22:00;0;0;0
piatok;1.11.2019;23:00;3;2;1
sobota;2.11.2019;0:00;0;0;0
sobota;2.11.2019;1:00;0;0;0
sobota;2.11.2019;2:00;0;0;0
sobota;2.11.2019;3:00;0;0;0
sobota;2.11.2019;4:00;0;0;0
sobota;2.11.2019;5:00;1;0;1
sobota;2.11.2019;6:00;1;1;0
sobota;2.11.2019;7:00;4;3;1
sobota;2.11.2019;8:00;5;2;3
sobota;2.11.2019;9:00;12;9;3
sobota;2.11.2019;10:00;22;14;8
sobota;2.11.2019;11:00;34;21;13
sobota;2.11.2019;12:00;25;11;14
sobota;2.11.2019;13:00;32;21;11
sobota;2.11.2019;14:00;38;21;17
sobota;2.11.2019;15:00;43;20;23
sobota;2.11.2019;16:00;24;10;14
sobota;2.11.2019;17:00;15;8;7
sobota;2.11.2019;18:00;3;2;1
sobota;2.11.2019;19:00;1;1;0
sobota;2.11.2019;20:00;5;0;5
sobota;2.11.2019;21:00;1;1;0
sobota;2.11.2019;22:00;3;1;2
sobota;2.11.2019;23:00;1;1;0
nedeľa;3.11.2019;0:00;1;0;1
nedeľa;3.11.2019;1:00;0;0;0
nedeľa;3.11.2019;2:00;0;0;0
nedeľa;3.11.2019;3:00;0;0;0
nedeľa;3.11.2019;4:00;0;0;0
nedeľa;3.11.2019;5:00;0;0;0
nedeľa;3.11.2019;6:00;1;1;0
nedeľa;3.11.2019;7:00;2;2;0
nedeľa;3.11.2019;8:00;4;3;1
nedeľa;3.11.2019;9:00;21;14;7
nedeľa;3.11.2019;10:00;62;44;18
nedeľa;3.11.2019;11:00;63;36;27
nedeľa;3.11.2019;12:00;58;38;20
nedeľa;3.11.2019;13:00;79;44;35
nedeľa;3.11.2019;14:00;85;46;39
nedeľa;3.11.2019;15:00;73;38;35
nedeľa;3.11.2019;16:00;69;30;39
nedeľa;3.11.2019;17:00;24;15;9
nedeľa;3.11.2019;18:00;16;11;5
nedeľa;3.11.2019;19:00;7;1;6
nedeľa;3.11.2019;20:00;8;3;5
nedeľa;3.11.2019;21:00;2;0;2
nedeľa;3.11.2019;22:00;5;4;1
nedeľa;3.11.2019;23:00;0;0;0
pondelok;4.11.2019;0:00;0;0;0
pondelok;4.11.2019;1:00;0;0;0
pondelok;4.11.2019;2:00;0;0;0
pondelok;4.11.2019;3:00;0;0;0
pondelok;4.11.2019;4:00;0;0;0
pondelok;4.11.2019;5:00;4;2;2
pondelok;4.11.2019;6:00;9;2;7
pondelok;4.11.2019;7:00;20;8;12
pondelok;4.11.2019;8:00;36;18;18
pondelok;4.11.2019;9:00;13;7;6
pondelok;4.11.2019;10:00;11;8;3
pondelok;4.11.2019;11:00;7;2;5
pondelok;4.11.2019;12:00;13;3;10
pondelok;4.11.2019;13:00;28;18;10
pondelok;4.11.2019;14:00;52;31;21
pondelok;4.11.2019;15:00;75;44;31
pondelok;4.11.2019;16:00;77;42;35
pondelok;4.11.2019;17:00;58;30;28
pondelok;4.11.2019;18:00;34;18;16
pondelok;4.11.2019;19:00;16;8;8
pondelok;4.11.2019;20:00;16;6;10
pondelok;4.11.2019;21:00;6;2;4
pondelok;4.11.2019;22:00;6;5;1
pondelok;4.11.2019;23:00;2;0;2
utorok;5.11.2019;0:00;0;0;0
utorok;5.11.2019;1:00;0;0;0
utorok;5.11.2019;2:00;0;0;0
utorok;5.11.2019;3:00;1;0;1
utorok;5.11.2019;4:00;1;1;0
utorok;5.11.2019;5:00;1;1;0
utorok;5.11.2019;6:00;13;7;6
utorok;5.11.2019;7:00;8;4;4
utorok;5.11.2019;8:00;15;8;7
utorok;5.11.2019;9:00;1;1;0
utorok;5.11.2019;10:00;0;0;0
utorok;5.11.2019;11:00;2;1;1
utorok;5.11.2019;12:00;0;0;0
utorok;5.11.2019;13:00;1;0;1
utorok;5.11.2019;14:00;6;3;3
utorok;5.11.2019;15:00;23;11;12
utorok;5.11.2019;16:00;16;9;7
utorok;5.11.2019;17:00;13;5;8
utorok;5.11.2019;18:00;8;4;4
utorok;5.11.2019;19:00;4;3;1
utorok;5.11.2019;20:00;4;2;2
utorok;5.11.2019;21:00;2;1;1
utorok;5.11.2019;22:00;0;0;0
utorok;5.11.2019;23:00;0;0;0
streda;6.11.2019;0:00;0;0;0
streda;6.11.2019;1:00;0;0;0
streda;6.11.2019;2:00;0;0;0
streda;6.11.2019;3:00;0;0;0
streda;6.11.2019;4:00;0;0;0
streda;6.11.2019;5:00;0;0;0
streda;6.11.2019;6:00;9;6;3
streda;6.11.2019;7:00;26;15;11
streda;6.11.2019;8:00;38;15;23
streda;6.11.2019;9:00;22;12;10
streda;6.11.2019;10:00;29;15;14
streda;6.11.2019;11:00;36;16;20
streda;6.11.2019;12:00;43;29;14
streda;6.11.2019;13:00;44;24;20
streda;6.11.2019;14:00;57;34;23
streda;6.11.2019;15:00;81;44;37
streda;6.11.2019;16:00;80;45;35
streda;6.11.2019;17:00;50;26;24
streda;6.11.2019;18:00;35;20;15
streda;6.11.2019;19:00;27;13;14
streda;6.11.2019;20:00;12;5;7
streda;6.11.2019;21:00;4;1;3
streda;6.11.2019;22:00;2;2;0
streda;6.11.2019;23:00;2;0;2
štvrtok;7.11.2019;0:00;0;0;0
štvrtok;7.11.2019;1:00;0;0;0
štvrtok;7.11.2019;2:00;0;0;0
štvrtok;7.11.2019;3:00;0;0;0
štvrtok;7.11.2019;4:00;0;0;0
štvrtok;7.11.2019;5:00;2;0;2
štvrtok;7.11.2019;6:00;23;13;10
štvrtok;7.11.2019;7:00;17;10;7
štvrtok;7.11.2019;8:00;37;15;22
štvrtok;7.11.2019;9:00;16;10;6
štvrtok;7.11.2019;10:00;8;2;6
štvrtok;7.11.2019;11:00;8;1;7
štvrtok;7.11.2019;12:00;15;9;6
štvrtok;7.11.2019;13:00;23;10;13
štvrtok;7.11.2019;14:00;22;13;9
štvrtok;7.11.2019;15:00;58;29;29
štvrtok;7.11.2019;16:00;57;25;32
štvrtok;7.11.2019;17:00;66;43;23
štvrtok;7.11.2019;18:00;33;15;18
štvrtok;7.11.2019;19:00;21;8;13
štvrtok;7.11.2019;20:00;8;5;3
štvrtok;7.11.2019;21:00;6;4;2
štvrtok;7.11.2019;22:00;3;2;1
štvrtok;7.11.2019;23:00;3;1;2
piatok;8.11.2019;0:00;2;0;2
piatok;8.11.2019;1:00;0;0;0
piatok;8.11.2019;2:00;0;0;0
piatok;8.11.2019;3:00;1;0;1
piatok;8.11.2019;4:00;0;0;0
piatok;8.11.2019;5:00;2;1;1
piatok;8.11.2019;6:00;14;8;6
piatok;8.11.2019;7:00;27;12;15
piatok;8.11.2019;8:00;44;14;30
piatok;8.11.2019;9:00;22;8;14
piatok;8.11.2019;10:00;13;5;8
piatok;8.11.2019;11:00;15;10;5
piatok;8.11.2019;12:00;13;5;8
piatok;8.11.2019;13:00;18;12;6
piatok;8.11.2019;14:00;37;23;14
piatok;8.11.2019;15:00;59;35;24
piatok;8.11.2019;16:00;60;37;23
piatok;8.11.2019;17:00;52;28;24
piatok;8.11.2019;18:00;22;13;9
piatok;8.11.2019;19:00;16;10;6
piatok;8.11.2019;20:00;6;2;4
piatok;8.11.2019;21:00;3;1;2
piatok;8.11.2019;22:00;3;1;2
piatok;8.11.2019;23:00;0;0;0
sobota;9.11.2019;0:00;1;1;0
sobota;9.11.2019;1:00;1;0;1
sobota;9.11.2019;2:00;0;0;0
sobota;9.11.2019;3:00;1;1;0
sobota;9.11.2019;4:00;0;0;0
sobota;9.11.2019;5:00;1;1;0
sobota;9.11.2019;6:00;0;0;0
sobota;9.11.2019;7:00;1;1;0
sobota;9.11.2019;8:00;5;1;4
sobota;9.11.2019;9:00;5;4;1
sobota;9.11.2019;10:00;1;1;0
sobota;9.11.2019;11:00;5;2;3
sobota;9.11.2019;12:00;7;4;3
sobota;9.11.2019;13:00;13;8;5
sobota;9.11.2019;14:00;21;6;15
sobota;9.11.2019;15:00;20;8;12
sobota;9.11.2019;16:00;23;9;14
sobota;9.11.2019;17:00;16;4;12
sobota;9.11.2019;18:00;9;1;8
sobota;9.11.2019;19:00;9;4;5
sobota;9.11.2019;20:00;9;1;8
sobota;9.11.2019;21:00;3;2;1
sobota;9.11.2019;22:00;2;0;2
sobota;9.11.2019;23:00;3;2;1
nedeľa;10.11.2019;0:00;3;0;3
nedeľa;10.11.2019;1:00;0;0;0
nedeľa;10.11.2019;2:00;0;0;0
nedeľa;10.11.2019;3:00;0;0;0
nedeľa;10.11.2019;4:00;1;1;0
nedeľa;10.11.2019;5:00;0;0;0
nedeľa;10.11.2019;6:00;1;1;0
nedeľa;10.11.2019;7:00;1;1;0
nedeľa;10.11.2019;8:00;7;4;3
nedeľa;10.11.2019;9:00;37;26;11
nedeľa;10.11.2019;10:00;45;26;19
nedeľa;10.11.2019;11:00;38;26;12
nedeľa;10.11.2019;12:00;50;26;24
nedeľa;10.11.2019;13:00;40;15;25
nedeľa;10.11.2019;14:00;31;19;12
nedeľa;10.11.2019;15:00;22;10;12
nedeľa;10.11.2019;16:00;22;12;10
nedeľa;10.11.2019;17:00;7;4;3
nedeľa;10.11.2019;18:00;9;5;4
nedeľa;10.11.2019;19:00;7;5;2
nedeľa;10.11.2019;20:00;2;1;1
nedeľa;10.11.2019;21:00;1;1;0
nedeľa;10.11.2019;22:00;2;1;1
nedeľa;10.11.2019;23:00;0;0;0
pondelok;11.11.2019;0:00;0;0;0
pondelok;11.11.2019;1:00;0;0;0
pondelok;11.11.2019;2:00;0;0;0
pondelok;11.11.2019;3:00;0;0;0
pondelok;11.11.2019;4:00;1;1;0
pondelok;11.11.2019;5:00;4;2;2
pondelok;11.11.2019;6:00;13;6;7
pondelok;11.11.2019;7:00;16;4;12
pondelok;11.11.2019;8:00;39;13;26
pondelok;11.11.2019;9:00;25;12;13
pondelok;11.11.2019;10:00;14;7;7
pondelok;11.11.2019;11:00;12;6;6
pondelok;11.11.2019;12:00;12;7;5
pondelok;11.11.2019;13:00;24;14;10
pondelok;11.11.2019;14:00;27;14;13
pondelok;11.11.2019;15:00;38;25;13
pondelok;11.11.2019;16:00;58;33;25
pondelok;11.11.2019;17:00;39;28;11
pondelok;11.11.2019;18:00;34;22;12
pondelok;11.11.2019;19:00;20;8;12
pondelok;11.11.2019;20:00;10;4;6
pondelok;11.11.2019;21:00;4;3;1
pondelok;11.11.2019;22:00;1;1;0
pondelok;11.11.2019;23:00;3;1;2
utorok;12.11.2019;0:00;0;0;0
utorok;12.11.2019;1:00;0;0;0
utorok;12.11.2019;2:00;1;1;0
utorok;12.11.2019;3:00;0;0;0
utorok;12.11.2019;4:00;1;1;0
utorok;12.11.2019;5:00;3;0;3
utorok;12.11.2019;6:00;13;7;6
utorok;12.11.2019;7:00;18;9;9
utorok;12.11.2019;8:00;34;13;21
utorok;12.11.2019;9:00;10;6;4
utorok;12.11.2019;10:00;15;10;5
utorok;12.11.2019;11:00;9;6;3
utorok;12.11.2019;12:00;12;5;7
utorok;12.11.2019;13:00;3;2;1
utorok;12.11.2019;14:00;1;1;0
utorok;12.11.2019;15:00;12;2;10
utorok;12.11.2019;16:00;13;6;7
utorok;12.11.2019;17:00;9;5;4
utorok;12.11.2019;18:00;9;4;5
utorok;12.11.2019;19:00;8;5;3
utorok;12.11.2019;20:00;3;1;2
utorok;12.11.2019;21:00;1;0;1
utorok;12.11.2019;22:00;1;1;0
utorok;12.11.2019;23:00;3;1;2
streda;13.11.2019;0:00;0;0;0
streda;13.11.2019;1:00;0;0;0
streda;13.11.2019;2:00;0;0;0
streda;13.11.2019;3:00;0;0;0
streda;13.11.2019;4:00;0;0;0
streda;13.11.2019;5:00;0;0;0
streda;13.11.2019;6:00;8;6;2
streda;13.11.2019;7:00;11;4;7
streda;13.11.2019;8:00;20;8;12
streda;13.11.2019;9:00;6;1;5
streda;13.11.2019;10:00;2;0;2
streda;13.11.2019;11:00;3;1;2
streda;13.11.2019;12:00;5;2;3
streda;13.11.2019;13:00;3;1;2
streda;13.11.2019;14:00;0;0;0
streda;13.11.2019;15:00;8;2;6
streda;13.11.2019;16:00;18;8;10
streda;13.11.2019;17:00;8;3;5
streda;13.11.2019;18:00;8;6;2
streda;13.11.2019;19:00;8;4;4
streda;13.11.2019;20:00;4;1;3
streda;13.11.2019;21:00;5;2;3
streda;13.11.2019;22:00;2;1;1
streda;13.11.2019;23:00;4;2;2
štvrtok;14.11.2019;0:00;1;0;1
štvrtok;14.11.2019;1:00;0;0;0
štvrtok;14.11.2019;2:00;0;0;0
štvrtok;14.11.2019;3:00;0;0;0
štvrtok;14.11.2019;4:00;0;0;0
štvrtok;14.11.2019;5:00;0;0;0
štvrtok;14.11.2019;6:00;8;6;2
štvrtok;14.11.2019;7:00;22;12;10
štvrtok;14.11.2019;8:00;43;22;21
štvrtok;14.11.2019;9:00;17;9;8
štvrtok;14.11.2019;10:00;10;6;4
štvrtok;14.11.2019;11:00;19;10;9
štvrtok;14.11.2019;12:00;21;14;7
štvrtok;14.11.2019;13:00;32;22;10
štvrtok;14.11.2019;14:00;31;18;13
štvrtok;14.11.2019;15:00;50;22;28
štvrtok;14.11.2019;16:00;56;31;25
štvrtok;14.11.2019;17:00;49;28;21
štvrtok;14.11.2019;18:00;21;16;5
štvrtok;14.11.2019;19:00;23;6;17
štvrtok;14.11.2019;20:00;10;1;9
štvrtok;14.11.2019;21:00;3;1;2
štvrtok;14.11.2019;22:00;7;4;3
štvrtok;14.11.2019;23:00;2;0;2
piatok;15.11.2019;0:00;1;1;0
piatok;15.11.2019;1:00;0;0;0
piatok;15.11.2019;2:00;0;0;0
piatok;15.11.2019;3:00;0;0;0
piatok;15.11.2019;4:00;0;0;0
piatok;15.11.2019;5:00;4;0;4
piatok;15.11.2019;6:00;14;8;6
piatok;15.11.2019;7:00;30;12;18
piatok;15.11.2019;8:00;32;18;14
piatok;15.11.2019;9:00;25;8;17
piatok;15.11.2019;10:00;13;6;7
piatok;15.11.2019;11:00;12;7;5
piatok;15.11.2019;12:00;13;11;2
piatok;15.11.2019;13:00;20;12;8
piatok;15.11.2019;14:00;30;18;12
piatok;15.11.2019;15:00;55;28;27
piatok;15.11.2019;16:00;58;27;31
piatok;15.11.2019;17:00;24;12;12
piatok;15.11.2019;18:00;26;16;10
piatok;15.11.2019;19:00;14;6;8
piatok;15.11.2019;20:00;6;3;3
piatok;15.11.2019;21:00;1;0;1
piatok;15.11.2019;22:00;2;2;0
piatok;15.11.2019;23:00;2;0;2
sobota;16.11.2019;0:00;3;1;2
sobota;16.11.2019;1:00;3;1;2
sobota;16.11.2019;2:00;0;0;0
sobota;16.11.2019;3:00;0;0;0
sobota;16.11.2019;4:00;0;0;0
sobota;16.11.2019;5:00;1;1;0
sobota;16.11.2019;6:00;0;0;0
sobota;16.11.2019;7:00;2;2;0
sobota;16.11.2019;8:00;1;1;0
sobota;16.11.2019;9:00;7;4;3
sobota;16.11.2019;10:00;9;7;2
sobota;16.11.2019;11:00;18;11;7
sobota;16.11.2019;12:00;14;7;7
sobota;16.11.2019;13:00;30;17;13
sobota;16.11.2019;14:00;43;29;14
sobota;16.11.2019;15:00;52;34;18
sobota;16.11.2019;16:00;37;11;26
sobota;16.11.2019;17:00;16;6;10
sobota;16.11.2019;18:00;32;9;23
sobota;16.11.2019;19:00;13;6;7
sobota;16.11.2019;20:00;10;5;5
sobota;16.11.2019;21:00;4;3;1
sobota;16.11.2019;22:00;0;0;0
sobota;16.11.2019;23:00;5;1;4
nedeľa;17.11.2019;0:00;1;1;0
nedeľa;17.11.2019;1:00;2;0;2
nedeľa;17.11.2019;2:00;2;1;1
nedeľa;17.11.2019;3:00;0;0;0
nedeľa;17.11.2019;4:00;0;0;0
nedeľa;17.11.2019;5:00;0;0;0
nedeľa;17.11.2019;6:00;2;1;1
nedeľa;17.11.2019;7:00;3;1;2
nedeľa;17.11.2019;8:00;10;5;5
nedeľa;17.11.2019;9:00;32;25;7
nedeľa;17.11.2019;10:00;119;88;31
nedeľa;17.11.2019;11:00;96;64;32
nedeľa;17.11.2019;12:00;100;65;35
nedeľa;17.11.2019;13:00;109;73;36
nedeľa;17.11.2019;14:00;145;75;70
nedeľa;17.11.2019;15:00;117;63;54
nedeľa;17.11.2019;16:00;63;25;38
nedeľa;17.11.2019;17:00;31;14;17
nedeľa;17.11.2019;18:00;17;10;7
nedeľa;17.11.2019;19:00;8;6;2
nedeľa;17.11.2019;20:00;2;0;2
nedeľa;17.11.2019;21:00;3;3;0
nedeľa;17.11.2019;22:00;3;0;3
nedeľa;17.11.2019;23:00;1;1;0
pondelok;18.11.2019;0:00;2;0;2
pondelok;18.11.2019;1:00;1;1;0
pondelok;18.11.2019;2:00;0;0;0
pondelok;18.11.2019;3:00;0;0;0
pondelok;18.11.2019;4:00;0;0;0
pondelok;18.11.2019;5:00;3;1;2
pondelok;18.11.2019;6:00;11;4;7
pondelok;18.11.2019;7:00;12;7;5
pondelok;18.11.2019;8:00;28;10;18
pondelok;18.11.2019;9:00;16;6;10
pondelok;18.11.2019;10:00;7;2;5
pondelok;18.11.2019;11:00;3;2;1
pondelok;18.11.2019;12:00;11;4;7
pondelok;18.11.2019;13:00;14;8;6
pondelok;18.11.2019;14:00;27;15;12
pondelok;18.11.2019;15:00;49;33;16
pondelok;18.11.2019;16:00;61;32;29
pondelok;18.11.2019;17:00;27;13;14
pondelok;18.11.2019;18:00;22;14;8
pondelok;18.11.2019;19:00;14;8;6
pondelok;18.11.2019;20:00;13;9;4
pondelok;18.11.2019;21:00;6;4;2
pondelok;18.11.2019;22:00;1;1;0
pondelok;18.11.2019;23:00;2;0;2
utorok;19.11.2019;0:00;1;1;0
utorok;19.11.2019;1:00;0;0;0
utorok;19.11.2019;2:00;0;0;0
utorok;19.11.2019;3:00;0;0;0
utorok;19.11.2019;4:00;1;0;1
utorok;19.11.2019;5:00;6;2;4
utorok;19.11.2019;6:00;18;11;7
utorok;19.11.2019;7:00;28;11;17
utorok;19.11.2019;8:00;45;23;22
utorok;19.11.2019;9:00;20;9;11
utorok;19.11.2019;10:00;27;19;8
utorok;19.11.2019;11:00;24;16;8
utorok;19.11.2019;12:00;33;15;18
utorok;19.11.2019;13:00;33;15;18
utorok;19.11.2019;14:00;40;25;15
utorok;19.11.2019;15:00;70;38;32
utorok;19.11.2019;16:00;74;42;32
utorok;19.11.2019;17:00;49;27;22
utorok;19.11.2019;18:00;23;15;8
utorok;19.11.2019;19:00;25;16;9
utorok;19.11.2019;20:00;5;2;3
utorok;19.11.2019;21:00;7;3;4
utorok;19.11.2019;22:00;3;1;2
utorok;19.11.2019;23:00;1;1;0
streda;20.11.2019;0:00;1;0;1
streda;20.11.2019;1:00;0;0;0
streda;20.11.2019;2:00;0;0;0
streda;20.11.2019;3:00;0;0;0
streda;20.11.2019;4:00;0;0;0
streda;20.11.2019;5:00;1;1;0
streda;20.11.2019;6:00;10;7;3
streda;20.11.2019;7:00;16;7;9
streda;20.11.2019;8:00;44;18;26
streda;20.11.2019;9:00;16;9;7
streda;20.11.2019;10:00;16;8;8
streda;20.11.2019;11:00;11;3;8
streda;20.11.2019;12:00;17;8;9
streda;20.11.2019;13:00;15;1;14
streda;20.11.2019;14:00;10;5;5
streda;20.11.2019;15:00;8;3;5
streda;20.11.2019;16:00;15;6;9
streda;20.11.2019;17:00;13;8;5
streda;20.11.2019;18:00;11;4;7
streda;20.11.2019;19:00;3;1;2
streda;20.11.2019;20:00;5;3;2
streda;20.11.2019;21:00;3;3;0
streda;20.11.2019;22:00;0;0;0
streda;20.11.2019;23:00;2;2;0
štvrtok;21.11.2019;0:00;1;0;1
štvrtok;21.11.2019;1:00;0;0;0
štvrtok;21.11.2019;2:00;0;0;0
štvrtok;21.11.2019;3:00;0;0;0
štvrtok;21.11.2019;4:00;0;0;0
štvrtok;21.11.2019;5:00;2;1;1
štvrtok;21.11.2019;6:00;7;4;3
štvrtok;21.11.2019;7:00;8;2;6
štvrtok;21.11.2019;8:00;21;4;17
štvrtok;21.11.2019;9:00;11;5;6
štvrtok;21.11.2019;10:00;8;1;7
štvrtok;21.11.2019;11:00;8;5;3
štvrtok;21.11.2019;12:00;7;5;2
štvrtok;21.11.2019;13:00;8;5;3
štvrtok;21.11.2019;14:00;12;6;6
štvrtok;21.11.2019;15:00;26;17;9
štvrtok;21.11.2019;16:00;34;21;13
štvrtok;21.11.2019;17:00;28;17;11
štvrtok;21.11.2019;18:00;23;14;9
štvrtok;21.11.2019;19:00;15;11;4
štvrtok;21.11.2019;20:00;4;2;2
štvrtok;21.11.2019;21:00;7;3;4
štvrtok;21.11.2019;22:00;7;6;1
štvrtok;21.11.2019;23:00;3;2;1
piatok;22.11.2019;0:00;0;0;0
piatok;22.11.2019;1:00;0;0;0
piatok;22.11.2019;2:00;0;0;0
piatok;22.11.2019;3:00;0;0;0
piatok;22.11.2019;4:00;1;0;1
piatok;22.11.2019;5:00;1;0;1
piatok;22.11.2019;6:00;12;9;3
piatok;22.11.2019;7:00;22;8;14
piatok;22.11.2019;8:00;35;15;20
piatok;22.11.2019;9:00;20;8;12
piatok;22.11.2019;10:00;25;16;9
piatok;22.11.2019;11:00;11;8;3
piatok;22.11.2019;12:00;19;7;12
piatok;22.11.2019;13:00;23;12;11
piatok;22.11.2019;14:00;20;9;11
piatok;22.11.2019;15:00;53;24;29
piatok;22.11.2019;16:00;29;14;15
piatok;22.11.2019;17:00;27;14;13
piatok;22.11.2019;18:00;17;13;4
piatok;22.11.2019;19:00;9;3;6
piatok;22.11.2019;20:00;6;2;4
piatok;22.11.2019;21:00;8;5;3
piatok;22.11.2019;22:00;3;2;1
piatok;22.11.2019;23:00;3;0;3
sobota;23.11.2019;0:00;2;2;0
sobota;23.11.2019;1:00;1;1;0
sobota;23.11.2019;2:00;1;0;1
sobota;23.11.2019;3:00;0;0;0
sobota;23.11.2019;4:00;0;0;0
sobota;23.11.2019;5:00;1;1;0
sobota;23.11.2019;6:00;4;2;2
sobota;23.11.2019;7:00;2;1;1
sobota;23.11.2019;8:00;11;5;6
sobota;23.11.2019;9:00;14;10;4
sobota;23.11.2019;10:00;28;23;5
sobota;23.11.2019;11:00;37;23;14
sobota;23.11.2019;12:00;55;27;28
sobota;23.11.2019;13:00;45;25;20
sobota;23.11.2019;14:00;52;29;23
sobota;23.11.2019;15:00;46;24;22
sobota;23.11.2019;16:00;30;9;21
sobota;23.11.2019;17:00;23;10;13
sobota;23.11.2019;18:00;13;2;11
sobota;23.11.2019;19:00;6;0;6
sobota;23.11.2019;20:00;4;3;1
sobota;23.11.2019;21:00;3;0;3
sobota;23.11.2019;22:00;1;1;0
sobota;23.11.2019;23:00;1;0;1
nedeľa;24.11.2019;0:00;2;2;0
nedeľa;24.11.2019;1:00;0;0;0
nedeľa;24.11.2019;2:00;0;0;0
nedeľa;24.11.2019;3:00;0;0;0
nedeľa;24.11.2019;4:00;1;1;0
nedeľa;24.11.2019;5:00;0;0;0
nedeľa;24.11.2019;6:00;1;1;0
nedeľa;24.11.2019;7:00;6;5;1
nedeľa;24.11.2019;8:00;7;4;3
nedeľa;24.11.2019;9:00;21;15;6
nedeľa;24.11.2019;10:00;46;31;15
nedeľa;24.11.2019;11:00;53;32;21
nedeľa;24.11.2019;12:00;71;43;28
nedeľa;24.11.2019;13:00;65;27;38
nedeľa;24.11.2019;14:00;68;39;29
nedeľa;24.11.2019;15:00;66;30;36
nedeľa;24.11.2019;16:00;37;19;18
nedeľa;24.11.2019;17:00;29;10;19
nedeľa;24.11.2019;18:00;14;2;12
nedeľa;24.11.2019;19:00;8;6;2
nedeľa;24.11.2019;20:00;7;2;5
nedeľa;24.11.2019;21:00;2;1;1
nedeľa;24.11.2019;22:00;4;3;1
nedeľa;24.11.2019;23:00;1;0;1
pondelok;25.11.2019;0:00;0;0;0
pondelok;25.11.2019;1:00;0;0;0
pondelok;25.11.2019;2:00;0;0;0
pondelok;25.11.2019;3:00;0;0;0
pondelok;25.11.2019;4:00;1;0;1
pondelok;25.11.2019;5:00;4;1;3
pondelok;25.11.2019;6:00;12;7;5
pondelok;25.11.2019;7:00;17;9;8
pondelok;25.11.2019;8:00;37;17;20
pondelok;25.11.2019;9:00;18;8;10
pondelok;25.11.2019;10:00;11;7;4
pondelok;25.11.2019;11:00;12;6;6
pondelok;25.11.2019;12:00;20;11;9
pondelok;25.11.2019;13:00;17;11;6
pondelok;25.11.2019;14:00;27;16;11
pondelok;25.11.2019;15:00;51;26;25
pondelok;25.11.2019;16:00;50;24;26
pondelok;25.11.2019;17:00;31;14;17
pondelok;25.11.2019;18:00;27;17;10
pondelok;25.11.2019;19:00;14;4;10
pondelok;25.11.2019;20:00;9;4;5
pondelok;25.11.2019;21:00;7;3;4
pondelok;25.11.2019;22:00;7;4;3
pondelok;25.11.2019;23:00;2;0;2
utorok;26.11.2019;0:00;1;1;0
utorok;26.11.2019;1:00;0;0;0
utorok;26.11.2019;2:00;0;0;0
utorok;26.11.2019;3:00;0;0;0
utorok;26.11.2019;4:00;0;0;0
utorok;26.11.2019;5:00;1;0;1
utorok;26.11.2019;6:00;13;9;4
utorok;26.11.2019;7:00;17;8;9
utorok;26.11.2019;8:00;40;18;22
utorok;26.11.2019;9:00;26;9;17
utorok;26.11.2019;10:00;14;12;2
utorok;26.11.2019;11:00;18;6;12
utorok;26.11.2019;12:00;15;10;5
utorok;26.11.2019;13:00;23;11;12
utorok;26.11.2019;14:00;24;10;14
utorok;26.11.2019;15:00;38;16;22
utorok;26.11.2019;16:00;53;35;18
utorok;26.11.2019;17:00;30;13;17
utorok;26.11.2019;18:00;31;19;12
utorok;26.11.2019;19:00;11;7;4
utorok;26.11.2019;20:00;7;3;4
utorok;26.11.2019;21:00;8;4;4
utorok;26.11.2019;22:00;4;2;2
utorok;26.11.2019;23:00;0;0;0
streda;27.11.2019;0:00;0;0;0
streda;27.11.2019;1:00;0;0;0
streda;27.11.2019;2:00;0;0;0
streda;27.11.2019;3:00;0;0;0
streda;27.11.2019;4:00;0;0;0
streda;27.11.2019;5:00;0;0;0
streda;27.11.2019;6:00;9;5;4
streda;27.11.2019;7:00;16;7;9
streda;27.11.2019;8:00;39;16;23
streda;27.11.2019;9:00;8;4;4
streda;27.11.2019;10:00;5;4;1
streda;27.11.2019;11:00;7;4;3
streda;27.11.2019;12:00;10;6;4
streda;27.11.2019;13:00;9;2;7
streda;27.11.2019;14:00;10;8;2
streda;27.11.2019;15:00;24;13;11
streda;27.11.2019;16:00;26;10;16
streda;27.11.2019;17:00;32;16;16
streda;27.11.2019;18:00;26;17;9
streda;27.11.2019;19:00;6;2;4
streda;27.11.2019;20:00;8;2;6
streda;27.11.2019;21:00;5;2;3
streda;27.11.2019;22:00;4;2;2
streda;27.11.2019;23:00;4;2;2
štvrtok;28.11.2019;0:00;1;0;1
štvrtok;28.11.2019;1:00;0;0;0
štvrtok;28.11.2019;2:00;0;0;0
štvrtok;28.11.2019;3:00;0;0;0
štvrtok;28.11.2019;4:00;0;0;0
štvrtok;28.11.2019;5:00;1;1;0
štvrtok;28.11.2019;6:00;6;4;2
štvrtok;28.11.2019;7:00;22;9;13
štvrtok;28.11.2019;8:00;33;14;19
štvrtok;28.11.2019;9:00;8;6;2
štvrtok;28.11.2019;10:00;20;11;9
štvrtok;28.11.2019;11:00;10;3;7
štvrtok;28.11.2019;12:00;12;7;5
štvrtok;28.11.2019;13:00;11;5;6
štvrtok;28.11.2019;14:00;6;2;4
štvrtok;28.11.2019;15:00;30;15;15
štvrtok;28.11.2019;16:00;26;14;12
štvrtok;28.11.2019;17:00;25;16;9
štvrtok;28.11.2019;18:00;12;6;6
štvrtok;28.11.2019;19:00;21;9;12
štvrtok;28.11.2019;20:00;7;2;5
štvrtok;28.11.2019;21:00;9;3;6
štvrtok;28.11.2019;22:00;5;0;5
štvrtok;28.11.2019;23:00;1;0;1
piatok;29.11.2019;0:00;0;0;0
piatok;29.11.2019;1:00;0;0;0
piatok;29.11.2019;2:00;1;0;1
piatok;29.11.2019;3:00;1;0;1
piatok;29.11.2019;4:00;0;0;0
piatok;29.11.2019;5:00;2;0;2
piatok;29.11.2019;6:00;7;5;2
piatok;29.11.2019;7:00;19;8;11
piatok;29.11.2019;8:00;23;13;10
piatok;29.11.2019;9:00;21;13;8
piatok;29.11.2019;10:00;13;6;7
piatok;29.11.2019;11:00;18;7;11
piatok;29.11.2019;12:00;16;11;5
piatok;29.11.2019;13:00;20;3;17
piatok;29.11.2019;14:00;28;16;12
piatok;29.11.2019;15:00;48;24;24
piatok;29.11.2019;16:00;39;17;22
piatok;29.11.2019;17:00;23;12;11
piatok;29.11.2019;18:00;16;6;10
piatok;29.11.2019;19:00;7;6;1
piatok;29.11.2019;20:00;4;2;2
piatok;29.11.2019;21:00;5;0;5
piatok;29.11.2019;22:00;3;0;3
piatok;29.11.2019;23:00;3;1;2
sobota;30.11.2019;0:00;3;2;1
sobota;30.11.2019;1:00;0;0;0
sobota;30.11.2019;2:00;2;0;2
sobota;30.11.2019;3:00;0;0;0
sobota;30.11.2019;4:00;0;0;0
sobota;30.11.2019;5:00;2;2;0
sobota;30.11.2019;6:00;1;1;0
sobota;30.11.2019;7:00;1;1;0
sobota;30.11.2019;8:00;3;2;1
sobota;30.11.2019;9:00;18;10;8
sobota;30.11.2019;10:00;38;27;11
sobota;30.11.2019;11:00;36;24;12
sobota;30.11.2019;12:00;61;30;31
sobota;30.11.2019;13:00;46;23;23
sobota;30.11.2019;14:00;39;16;23
sobota;30.11.2019;15:00;35;11;24
sobota;30.11.2019;16:00;28;7;21
sobota;30.11.2019;17:00;18;3;15
sobota;30.11.2019;18:00;18;2;16
sobota;30.11.2019;19:00;8;3;5
sobota;30.11.2019;20:00;5;0;5
sobota;30.11.2019;21:00;3;1;2
sobota;30.11.2019;22:00;5;3;2
sobota;30.11.2019;23:00;7;1;6
nedeľa;1.12.2019;0:00;0;0;0
nedeľa;1.12.2019;1:00;0;0;0
nedeľa;1.12.2019;2:00;0;0;0
nedeľa;1.12.2019;3:00;0;0;0
nedeľa;1.12.2019;4:00;0;0;0
nedeľa;1.12.2019;5:00;0;0;0
nedeľa;1.12.2019;6:00;2;2;0
nedeľa;1.12.2019;7:00;0;0;0
nedeľa;1.12.2019;8:00;7;4;3
nedeľa;1.12.2019;9:00;14;10;4
nedeľa;1.12.2019;10:00;24;16;8
nedeľa;1.12.2019;11:00;37;21;16
nedeľa;1.12.2019;12:00;29;16;13
nedeľa;1.12.2019;13:00;27;18;9
nedeľa;1.12.2019;14:00;27;14;13
nedeľa;1.12.2019;15:00;20;10;10
nedeľa;1.12.2019;16:00;13;7;6
nedeľa;1.12.2019;17:00;5;1;4
nedeľa;1.12.2019;18:00;7;2;5
nedeľa;1.12.2019;19:00;5;0;5
nedeľa;1.12.2019;20:00;2;2;0
nedeľa;1.12.2019;21:00;1;1;0
nedeľa;1.12.2019;22:00;2;2;0
nedeľa;1.12.2019;23:00;2;0;2
pondelok;2.12.2019;0:00;0;0;0
pondelok;2.12.2019;1:00;0;0;0
pondelok;2.12.2019;2:00;0;0;0
pondelok;2.12.2019;3:00;0;0;0
pondelok;2.12.2019;4:00;1;1;0
pondelok;2.12.2019;5:00;2;0;2
pondelok;2.12.2019;6:00;4;4;0
pondelok;2.12.2019;7:00;7;5;2
pondelok;2.12.2019;8:00;16;6;10
pondelok;2.12.2019;9:00;7;3;4
pondelok;2.12.2019;10:00;1;0;1
pondelok;2.12.2019;11:00;3;3;0
pondelok;2.12.2019;12:00;4;0;4
pondelok;2.12.2019;13:00;2;2;0
pondelok;2.12.2019;14:00;4;3;1
pondelok;2.12.2019;15:00;14;6;8
pondelok;2.12.2019;16:00;17;5;12
pondelok;2.12.2019;17:00;15;7;8
pondelok;2.12.2019;18:00;12;5;7
pondelok;2.12.2019;19:00;11;0;11
pondelok;2.12.2019;20:00;12;2;10
pondelok;2.12.2019;21:00;16;1;15
pondelok;2.12.2019;22:00;1;0;1
pondelok;2.12.2019;23:00;0;0;0
utorok;3.12.2019;0:00;0;0;0
utorok;3.12.2019;1:00;0;0;0
utorok;3.12.2019;2:00;3;0;3
utorok;3.12.2019;3:00;0;0;0
utorok;3.12.2019;4:00;0;0;0
utorok;3.12.2019;5:00;2;1;1
utorok;3.12.2019;6:00;5;3;2
utorok;3.12.2019;7:00;17;9;8
utorok;3.12.2019;8:00;19;9;10
utorok;3.12.2019;9:00;16;7;9
utorok;3.12.2019;10:00;12;7;5
utorok;3.12.2019;11:00;7;1;6
utorok;3.12.2019;12:00;8;3;5
utorok;3.12.2019;13:00;21;15;6
utorok;3.12.2019;14:00;15;12;3
utorok;3.12.2019;15:00;21;10;11
utorok;3.12.2019;16:00;30;14;16
utorok;3.12.2019;17:00;26;17;9
utorok;3.12.2019;18:00;23;13;10
utorok;3.12.2019;19:00;6;4;2
utorok;3.12.2019;20:00;5;2;3
utorok;3.12.2019;21:00;4;3;1
utorok;3.12.2019;22:00;4;2;2
utorok;3.12.2019;23:00;2;0;2
streda;4.12.2019;0:00;0;0;0
streda;4.12.2019;1:00;0;0;0
streda;4.12.2019;2:00;0;0;0
streda;4.12.2019;3:00;0;0;0
streda;4.12.2019;4:00;1;0;1
streda;4.12.2019;5:00;0;0;0
streda;4.12.2019;6:00;10;6;4
streda;4.12.2019;7:00;7;3;4
streda;4.12.2019;8:00;27;11;16
streda;4.12.2019;9:00;9;3;6
streda;4.12.2019;10:00;7;5;2
streda;4.12.2019;11:00;4;1;3
streda;4.12.2019;12:00;9;4;5
streda;4.12.2019;13:00;9;5;4
streda;4.12.2019;14:00;11;3;8
streda;4.12.2019;15:00;22;14;8
streda;4.12.2019;16:00;24;13;11
streda;4.12.2019;17:00;34;16;18
streda;4.12.2019;18:00;20;13;7
streda;4.12.2019;19:00;7;0;7
streda;4.12.2019;20:00;10;3;7
streda;4.12.2019;21:00;6;2;4
streda;4.12.2019;22:00;9;1;8
streda;4.12.2019;23:00;5;1;4
štvrtok;5.12.2019;0:00;1;0;1
štvrtok;5.12.2019;1:00;0;0;0
štvrtok;5.12.2019;2:00;1;1;0
štvrtok;5.12.2019;3:00;0;0;0
štvrtok;5.12.2019;4:00;0;0;0
štvrtok;5.12.2019;5:00;1;1;0
štvrtok;5.12.2019;6:00;3;2;1
štvrtok;5.12.2019;7:00;11;5;6
štvrtok;5.12.2019;8:00;16;6;10
štvrtok;5.12.2019;9:00;11;4;7
štvrtok;5.12.2019;10:00;4;2;2
štvrtok;5.12.2019;11:00;8;4;4
štvrtok;5.12.2019;12:00;10;7;3
štvrtok;5.12.2019;13:00;3;2;1
štvrtok;5.12.2019;14:00;12;6;6
štvrtok;5.12.2019;15:00;15;10;5
štvrtok;5.12.2019;16:00;21;10;11
štvrtok;5.12.2019;17:00;18;9;9
štvrtok;5.12.2019;18:00;21;11;10
štvrtok;5.12.2019;19:00;24;5;19
štvrtok;5.12.2019;20:00;21;4;17
štvrtok;5.12.2019;21:00;11;2;9
štvrtok;5.12.2019;22:00;7;2;5
štvrtok;5.12.2019;23:00;6;2;4
piatok;6.12.2019;0:00;1;1;0
piatok;6.12.2019;1:00;0;0;0
piatok;6.12.2019;2:00;0;0;0
piatok;6.12.2019;3:00;0;0;0
piatok;6.12.2019;4:00;0;0;0
piatok;6.12.2019;5:00;0;0;0
piatok;6.12.2019;6:00;9;5;4
piatok;6.12.2019;7:00;11;7;4
piatok;6.12.2019;8:00;23;8;15
piatok;6.12.2019;9:00;14;8;6
piatok;6.12.2019;10:00;9;6;3
piatok;6.12.2019;11:00;11;4;7
piatok;6.12.2019;12:00;9;5;4
piatok;6.12.2019;13:00;16;6;10
piatok;6.12.2019;14:00;14;7;7
piatok;6.12.2019;15:00;31;18;13
piatok;6.12.2019;16:00;36;12;24
piatok;6.12.2019;17:00;25;9;16
piatok;6.12.2019;18:00;16;6;10
piatok;6.12.2019;19:00;9;3;6
piatok;6.12.2019;20:00;20;2;18
piatok;6.12.2019;21:00;11;0;11
piatok;6.12.2019;22:00;7;2;5
piatok;6.12.2019;23:00;6;0;6
sobota;7.12.2019;0:00;2;1;1
sobota;7.12.2019;1:00;1;1;0
sobota;7.12.2019;2:00;1;0;1
sobota;7.12.2019;3:00;0;0;0
sobota;7.12.2019;4:00;0;0;0
sobota;7.12.2019;5:00;0;0;0
sobota;7.12.2019;6:00;0;0;0
sobota;7.12.2019;7:00;4;3;1
sobota;7.12.2019;8:00;4;3;1
sobota;7.12.2019;9:00;4;2;2
sobota;7.12.2019;10:00;3;1;2
sobota;7.12.2019;11:00;2;1;1
sobota;7.12.2019;12:00;5;3;2
sobota;7.12.2019;13:00;9;3;6
sobota;7.12.2019;14:00;16;3;13
sobota;7.12.2019;15:00;11;3;8
sobota;7.12.2019;16:00;25;4;21
sobota;7.12.2019;17:00;11;7;4
sobota;7.12.2019;18:00;13;4;9
sobota;7.12.2019;19:00;3;0;3
sobota;7.12.2019;20:00;4;2;2
sobota;7.12.2019;21:00;1;1;0
sobota;7.12.2019;22:00;0;0;0
sobota;7.12.2019;23:00;1;0;1
nedeľa;8.12.2019;0:00;1;1;0
nedeľa;8.12.2019;1:00;1;0;1
nedeľa;8.12.2019;2:00;1;1;0
nedeľa;8.12.2019;3:00;0;0;0
nedeľa;8.12.2019;4:00;0;0;0
nedeľa;8.12.2019;5:00;0;0;0
nedeľa;8.12.2019;6:00;1;1;0
nedeľa;8.12.2019;7:00;2;2;0
nedeľa;8.12.2019;8:00;10;6;4
nedeľa;8.12.2019;9:00;15;7;8
nedeľa;8.12.2019;10:00;24;18;6
nedeľa;8.12.2019;11:00;50;33;17
nedeľa;8.12.2019;12:00;55;29;26
nedeľa;8.12.2019;13:00;60;26;34
nedeľa;8.12.2019;14:00;71;33;38
nedeľa;8.12.2019;15:00;57;30;27
nedeľa;8.12.2019;16:00;31;11;20
nedeľa;8.12.2019;17:00;24;6;18
nedeľa;8.12.2019;18:00;9;3;6
nedeľa;8.12.2019;19:00;8;3;5
nedeľa;8.12.2019;20:00;7;1;6
nedeľa;8.12.2019;21:00;0;0;0
nedeľa;8.12.2019;22:00;3;2;1
nedeľa;8.12.2019;23:00;2;1;1
pondelok;9.12.2019;0:00;0;0;0
pondelok;9.12.2019;1:00;0;0;0
pondelok;9.12.2019;2:00;0;0;0
pondelok;9.12.2019;3:00;0;0;0
pondelok;9.12.2019;4:00;1;0;1
pondelok;9.12.2019;5:00;0;0;0
pondelok;9.12.2019;6:00;7;2;5
pondelok;9.12.2019;7:00;17;9;8
pondelok;9.12.2019;8:00;24;11;13
pondelok;9.12.2019;9:00;10;3;7
pondelok;9.12.2019;10:00;8;2;6
pondelok;9.12.2019;11:00;8;3;5
pondelok;9.12.2019;12:00;12;7;5
pondelok;9.12.2019;13:00;11;8;3
pondelok;9.12.2019;14:00;6;4;2
pondelok;9.12.2019;15:00;14;6;8
pondelok;9.12.2019;16:00;18;5;13
pondelok;9.12.2019;17:00;19;10;9
pondelok;9.12.2019;18:00;13;11;2
pondelok;9.12.2019;19:00;5;2;3
pondelok;9.12.2019;20:00;2;0;2
pondelok;9.12.2019;21:00;3;3;0
pondelok;9.12.2019;22:00;1;1;0
pondelok;9.12.2019;23:00;2;1;1
utorok;10.12.2019;0:00;0;0;0
utorok;10.12.2019;1:00;0;0;0
utorok;10.12.2019;2:00;0;0;0
utorok;10.12.2019;3:00;0;0;0
utorok;10.12.2019;4:00;0;0;0
utorok;10.12.2019;5:00;1;0;1
utorok;10.12.2019;6:00;5;4;1
utorok;10.12.2019;7:00;12;4;8
utorok;10.12.2019;8:00;23;12;11
utorok;10.12.2019;9:00;17;6;11
utorok;10.12.2019;10:00;8;5;3
utorok;10.12.2019;11:00;14;7;7
utorok;10.12.2019;12:00;11;5;6
utorok;10.12.2019;13:00;12;6;6
utorok;10.12.2019;14:00;14;7;7
utorok;10.12.2019;15:00;25;12;13
utorok;10.12.2019;16:00;25;12;13
utorok;10.12.2019;17:00;26;13;13
utorok;10.12.2019;18:00;20;13;7
utorok;10.12.2019;19:00;6;3;3
utorok;10.12.2019;20:00;9;3;6
utorok;10.12.2019;21:00;3;3;0
utorok;10.12.2019;22:00;0;0;0
utorok;10.12.2019;23:00;2;0;2
streda;11.12.2019;0:00;2;0;2
streda;11.12.2019;1:00;0;0;0
streda;11.12.2019;2:00;0;0;0
streda;11.12.2019;3:00;0;0;0
streda;11.12.2019;4:00;0;0;0
streda;11.12.2019;5:00;2;0;2
streda;11.12.2019;6:00;6;5;1
streda;11.12.2019;7:00;13;4;9
streda;11.12.2019;8:00;24;12;12
streda;11.12.2019;9:00;11;6;5
streda;11.12.2019;10:00;11;6;5
streda;11.12.2019;11:00;13;6;7
streda;11.12.2019;12:00;3;3;0
streda;11.12.2019;13:00;18;8;10
streda;11.12.2019;14:00;22;10;12
streda;11.12.2019;15:00;25;16;9
streda;11.12.2019;16:00;21;9;12
streda;11.12.2019;17:00;21;8;13
streda;11.12.2019;18:00;12;8;4
streda;11.12.2019;19:00;12;7;5
streda;11.12.2019;20:00;4;1;3
streda;11.12.2019;21:00;3;1;2
streda;11.12.2019;22:00;3;2;1
streda;11.12.2019;23:00;2;1;1
štvrtok;12.12.2019;0:00;2;0;2
štvrtok;12.12.2019;1:00;0;0;0
štvrtok;12.12.2019;2:00;0;0;0
štvrtok;12.12.2019;3:00;0;0;0
štvrtok;12.12.2019;4:00;0;0;0
štvrtok;12.12.2019;5:00;1;0;1
štvrtok;12.12.2019;6:00;5;2;3
štvrtok;12.12.2019;7:00;15;7;8
štvrtok;12.12.2019;8:00;27;11;16
štvrtok;12.12.2019;9:00;6;4;2
štvrtok;12.12.2019;10:00;5;4;1
štvrtok;12.12.2019;11:00;4;3;1
štvrtok;12.12.2019;12:00;3;3;0
štvrtok;12.12.2019;13:00;2;1;1
štvrtok;12.12.2019;14:00;5;2;3
štvrtok;12.12.2019;15:00;12;5;7
štvrtok;12.12.2019;16:00;18;9;9
štvrtok;12.12.2019;17:00;22;12;10
štvrtok;12.12.2019;18:00;17;5;12
štvrtok;12.12.2019;19:00;9;2;7
štvrtok;12.12.2019;20:00;3;3;0
štvrtok;12.12.2019;21:00;1;1;0
štvrtok;12.12.2019;22:00;8;2;6
štvrtok;12.12.2019;23:00;3;0;3
piatok;13.12.2019;0:00;2;0;2
piatok;13.12.2019;1:00;0;0;0
piatok;13.12.2019;2:00;0;0;0
piatok;13.12.2019;3:00;1;1;0
piatok;13.12.2019;4:00;0;0;0
piatok;13.12.2019;5:00;1;0;1
piatok;13.12.2019;6:00;5;2;3
piatok;13.12.2019;7:00;7;3;4
piatok;13.12.2019;8:00;12;6;6
piatok;13.12.2019;9:00;10;8;2
piatok;13.12.2019;10:00;6;3;3
piatok;13.12.2019;11:00;6;4;2
piatok;13.12.2019;12:00;3;1;2
piatok;13.12.2019;13:00;8;7;1
piatok;13.12.2019;14:00;8;2;6
piatok;13.12.2019;15:00;14;10;4
piatok;13.12.2019;16:00;17;3;14
piatok;13.12.2019;17:00;23;11;12
piatok;13.12.2019;18:00;2;1;1
piatok;13.12.2019;19:00;7;3;4
piatok;13.12.2019;20:00;4;1;3
piatok;13.12.2019;21:00;5;3;2
piatok;13.12.2019;22:00;1;1;0
piatok;13.12.2019;23:00;0;0;0
sobota;14.12.2019;0:00;4;1;3
sobota;14.12.2019;1:00;0;0;0
sobota;14.12.2019;2:00;0;0;0
sobota;14.12.2019;3:00;1;0;1
sobota;14.12.2019;4:00;0;0;0
sobota;14.12.2019;5:00;1;0;1
sobota;14.12.2019;6:00;1;1;0
sobota;14.12.2019;7:00;2;1;1
sobota;14.12.2019;8:00;9;3;6
sobota;14.12.2019;9:00;2;0;2
sobota;14.12.2019;10:00;29;23;6
sobota;14.12.2019;11:00;37;20;17
sobota;14.12.2019;12:00;40;18;22
sobota;14.12.2019;13:00;27;11;16
sobota;14.12.2019;14:00;17;8;9
sobota;14.12.2019;15:00;20;7;13
sobota;14.12.2019;16:00;20;3;17
sobota;14.12.2019;17:00;19;3;16
sobota;14.12.2019;18:00;12;2;10
sobota;14.12.2019;19:00;14;1;13
sobota;14.12.2019;20:00;8;1;7
sobota;14.12.2019;21:00;3;0;3
sobota;14.12.2019;22:00;0;0;0
sobota;14.12.2019;23:00;5;3;2
nedeľa;15.12.2019;0:00;2;1;1
nedeľa;15.12.2019;1:00;1;1;0
nedeľa;15.12.2019;2:00;0;0;0
nedeľa;15.12.2019;3:00;0;0;0
nedeľa;15.12.2019;4:00;1;0;1
nedeľa;15.12.2019;5:00;0;0;0
nedeľa;15.12.2019;6:00;0;0;0
nedeľa;15.12.2019;7:00;2;1;1
nedeľa;15.12.2019;8:00;5;3;2
nedeľa;15.12.2019;9:00;8;4;4
nedeľa;15.12.2019;10:00;24;14;10
nedeľa;15.12.2019;11:00;25;18;7
nedeľa;15.12.2019;12:00;43;21;22
nedeľa;15.12.2019;13:00;37;26;11
nedeľa;15.12.2019;14:00;43;21;22
nedeľa;15.12.2019;15:00;29;16;13
nedeľa;15.12.2019;16:00;26;11;15
nedeľa;15.12.2019;17:00;9;5;4
nedeľa;15.12.2019;18:00;5;3;2
nedeľa;15.12.2019;19:00;2;2;0
nedeľa;15.12.2019;20:00;5;4;1
nedeľa;15.12.2019;21:00;2;1;1
nedeľa;15.12.2019;22:00;2;1;1
nedeľa;15.12.2019;23:00;2;1;1
pondelok;16.12.2019;0:00;1;0;1
pondelok;16.12.2019;1:00;0;0;0
pondelok;16.12.2019;2:00;0;0;0
pondelok;16.12.2019;3:00;0;0;0
pondelok;16.12.2019;4:00;0;0;0
pondelok;16.12.2019;5:00;3;1;2
pondelok;16.12.2019;6:00;7;4;3
pondelok;16.12.2019;7:00;20;7;13
pondelok;16.12.2019;8:00;34;15;19
pondelok;16.12.2019;9:00;9;5;4
pondelok;16.12.2019;10:00;11;9;2
pondelok;16.12.2019;11:00;10;6;4
pondelok;16.12.2019;12:00;13;7;6
pondelok;16.12.2019;13:00;19;6;13
pondelok;16.12.2019;14:00;20;12;8
pondelok;16.12.2019;15:00;28;16;12
pondelok;16.12.2019;16:00;30;11;19
pondelok;16.12.2019;17:00;26;11;15
pondelok;16.12.2019;18:00;16;11;5
pondelok;16.12.2019;19:00;14;9;5
pondelok;16.12.2019;20:00;7;4;3
pondelok;16.12.2019;21:00;2;1;1
pondelok;16.12.2019;22:00;0;0;0
pondelok;16.12.2019;23:00;1;1;0
utorok;17.12.2019;0:00;1;0;1
utorok;17.12.2019;1:00;0;0;0
utorok;17.12.2019;2:00;0;0;0
utorok;17.12.2019;3:00;0;0;0
utorok;17.12.2019;4:00;0;0;0
utorok;17.12.2019;5:00;0;0;0
utorok;17.12.2019;6:00;11;7;4
utorok;17.12.2019;7:00;17;7;10
utorok;17.12.2019;8:00;35;18;17
utorok;17.12.2019;9:00;12;6;6
utorok;17.12.2019;10:00;12;7;5
utorok;17.12.2019;11:00;17;8;9
utorok;17.12.2019;12:00;17;10;7
utorok;17.12.2019;13:00;12;6;6
utorok;17.12.2019;14:00;22;14;8
utorok;17.12.2019;15:00;37;15;22
utorok;17.12.2019;16:00;47;25;22
utorok;17.12.2019;17:00;29;15;14
utorok;17.12.2019;18:00;26;10;16
utorok;17.12.2019;19:00;9;4;5
utorok;17.12.2019;20:00;4;1;3
utorok;17.12.2019;21:00;3;0;3
utorok;17.12.2019;22:00;0;0;0
utorok;17.12.2019;23:00;1;0;1
streda;18.12.2019;0:00;0;0;0
streda;18.12.2019;1:00;0;0;0
streda;18.12.2019;2:00;1;1;0
streda;18.12.2019;3:00;0;0;0
streda;18.12.2019;4:00;0;0;0
streda;18.12.2019;5:00;3;2;1
streda;18.12.2019;6:00;16;11;5
streda;18.12.2019;7:00;27;14;13
streda;18.12.2019;8:00;32;11;21
streda;18.12.2019;9:00;18;11;7
streda;18.12.2019;10:00;15;7;8
streda;18.12.2019;11:00;21;14;7
streda;18.12.2019;12:00;29;16;13
streda;18.12.2019;13:00;44;22;22
streda;18.12.2019;14:00;50;25;25
streda;18.12.2019;15:00;65;31;34
streda;18.12.2019;16:00;55;25;30
streda;18.12.2019;17:00;41;19;22
streda;18.12.2019;18:00;26;10;16
streda;18.12.2019;19:00;12;5;7
streda;18.12.2019;20:00;13;6;7
streda;18.12.2019;21:00;6;2;4
streda;18.12.2019;22:00;12;4;8
streda;18.12.2019;23:00;4;2;2
štvrtok;19.12.2019;0:00;0;0;0
štvrtok;19.12.2019;1:00;2;0;2
štvrtok;19.12.2019;2:00;1;0;1
štvrtok;19.12.2019;3:00;0;0;0
štvrtok;19.12.2019;4:00;0;0;0
štvrtok;19.12.2019;5:00;4;0;4
štvrtok;19.12.2019;6:00;5;3;2
štvrtok;19.12.2019;7:00;13;5;8
štvrtok;19.12.2019;8:00;18;6;12
štvrtok;19.12.2019;9:00;28;12;16
štvrtok;19.12.2019;10:00;11;6;5
štvrtok;19.12.2019;11:00;29;21;8
štvrtok;19.12.2019;12:00;11;5;6
štvrtok;19.12.2019;13:00;20;12;8
štvrtok;19.12.2019;14:00;34;16;18
štvrtok;19.12.2019;15:00;26;13;13
štvrtok;19.12.2019;16:00;24;12;12
štvrtok;19.12.2019;17:00;27;17;10
štvrtok;19.12.2019;18:00;18;8;10
štvrtok;19.12.2019;19:00;18;5;13
štvrtok;19.12.2019;20:00;9;6;3
štvrtok;19.12.2019;21:00;5;2;3
štvrtok;19.12.2019;22:00;3;3;0
štvrtok;19.12.2019;23:00;3;1;2
piatok;20.12.2019;0:00;4;2;2
piatok;20.12.2019;1:00;0;0;0
piatok;20.12.2019;2:00;0;0;0
piatok;20.12.2019;3:00;1;0;1
piatok;20.12.2019;4:00;0;0;0
piatok;20.12.2019;5:00;4;0;4
piatok;20.12.2019;6:00;6;3;3
piatok;20.12.2019;7:00;17;10;7
piatok;20.12.2019;8:00;20;10;10
piatok;20.12.2019;9:00;14;6;8
piatok;20.12.2019;10:00;22;15;7
piatok;20.12.2019;11:00;25;15;10
piatok;20.12.2019;12:00;28;12;16
piatok;20.12.2019;13:00;35;20;15
piatok;20.12.2019;14:00;53;21;32
piatok;20.12.2019;15:00;36;17;19
piatok;20.12.2019;16:00;31;16;15
piatok;20.12.2019;17:00;25;9;16
piatok;20.12.2019;18:00;13;9;4
piatok;20.12.2019;19:00;7;3;4
piatok;20.12.2019;20:00;5;2;3
piatok;20.12.2019;21:00;3;1;2
piatok;20.12.2019;22:00;4;4;0
piatok;20.12.2019;23:00;3;0;3
sobota;21.12.2019;0:00;5;0;5
sobota;21.12.2019;1:00;6;1;5
sobota;21.12.2019;2:00;0;0;0
sobota;21.12.2019;3:00;0;0;0
sobota;21.12.2019;4:00;0;0;0
sobota;21.12.2019;5:00;1;0;1
sobota;21.12.2019;6:00;3;0;3
sobota;21.12.2019;7:00;4;4;0
sobota;21.12.2019;8:00;16;10;6
sobota;21.12.2019;9:00;20;14;6
sobota;21.12.2019;10:00;33;16;17
sobota;21.12.2019;11:00;37;20;17
sobota;21.12.2019;12:00;20;13;7
sobota;21.12.2019;13:00;16;6;10
sobota;21.12.2019;14:00;4;3;1
sobota;21.12.2019;15:00;4;2;2
sobota;21.12.2019;16:00;4;1;3
sobota;21.12.2019;17:00;2;1;1
sobota;21.12.2019;18:00;2;1;1
sobota;21.12.2019;19:00;0;0;0
sobota;21.12.2019;20:00;2;1;1
sobota;21.12.2019;21:00;2;2;0
sobota;21.12.2019;22:00;0;0;0
sobota;21.12.2019;23:00;0;0;0
nedeľa;22.12.2019;0:00;1;0;1
nedeľa;22.12.2019;1:00;0;0;0
nedeľa;22.12.2019;2:00;0;0;0
nedeľa;22.12.2019;3:00;0;0;0
nedeľa;22.12.2019;4:00;0;0;0
nedeľa;22.12.2019;5:00;0;0;0
nedeľa;22.12.2019;6:00;0;0;0
nedeľa;22.12.2019;7:00;2;1;1
nedeľa;22.12.2019;8:00;10;7;3
nedeľa;22.12.2019;9:00;16;6;10
nedeľa;22.12.2019;10:00;34;17;17
nedeľa;22.12.2019;11:00;22;15;7
nedeľa;22.12.2019;12:00;44;29;15
nedeľa;22.12.2019;13:00;24;12;12
nedeľa;22.12.2019;14:00;21;9;12
nedeľa;22.12.2019;15:00;15;9;6
nedeľa;22.12.2019;16:00;14;4;10
nedeľa;22.12.2019;17:00;6;0;6
nedeľa;22.12.2019;18:00;5;1;4
nedeľa;22.12.2019;19:00;2;1;1
nedeľa;22.12.2019;20:00;0;0;0
nedeľa;22.12.2019;21:00;0;0;0
nedeľa;22.12.2019;22:00;1;1;0
nedeľa;22.12.2019;23:00;1;1;0
pondelok;23.12.2019;0:00;1;0;1
pondelok;23.12.2019;1:00;0;0;0
pondelok;23.12.2019;2:00;0;0;0
pondelok;23.12.2019;3:00;0;0;0
pondelok;23.12.2019;4:00;0;0;0
pondelok;23.12.2019;5:00;0;0;0
pondelok;23.12.2019;6:00;1;1;0
pondelok;23.12.2019;7:00;1;1;0
pondelok;23.12.2019;8:00;1;0;1
pondelok;23.12.2019;9:00;1;0;1
pondelok;23.12.2019;10:00;0;0;0
pondelok;23.12.2019;11:00;1;0;1
pondelok;23.12.2019;12:00;1;0;1
pondelok;23.12.2019;13:00;2;0;2
pondelok;23.12.2019;14:00;4;0;4
pondelok;23.12.2019;15:00;3;2;1
pondelok;23.12.2019;16:00;5;2;3
pondelok;23.12.2019;17:00;3;1;2
pondelok;23.12.2019;18:00;3;1;2
pondelok;23.12.2019;19:00;1;0;1
pondelok;23.12.2019;20:00;0;0;0
pondelok;23.12.2019;21:00;0;0;0
pondelok;23.12.2019;22:00;1;0;1
pondelok;23.12.2019;23:00;0;0;0
utorok;24.12.2019;0:00;0;0;0
utorok;24.12.2019;1:00;0;0;0
utorok;24.12.2019;2:00;1;0;1
utorok;24.12.2019;3:00;0;0;0
utorok;24.12.2019;4:00;0;0;0
utorok;24.12.2019;5:00;0;0;0
utorok;24.12.2019;6:00;2;2;0
utorok;24.12.2019;7:00;5;1;4
utorok;24.12.2019;8:00;9;5;4
utorok;24.12.2019;9:00;10;7;3
utorok;24.12.2019;10:00;28;17;11
utorok;24.12.2019;11:00;35;25;10
utorok;24.12.2019;12:00;35;17;18
utorok;24.12.2019;13:00;33;21;12
utorok;24.12.2019;14:00;29;20;9
utorok;24.12.2019;15:00;20;9;11
utorok;24.12.2019;16:00;3;2;1
utorok;24.12.2019;17:00;0;0;0
utorok;24.12.2019;18:00;0;0;0
utorok;24.12.2019;19:00;1;0;1
utorok;24.12.2019;20:00;1;1;0
utorok;24.12.2019;21:00;1;0;1
utorok;24.12.2019;22:00;0;0;0
utorok;24.12.2019;23:00;1;1;0
streda;25.12.2019;0:00;1;0;1
streda;25.12.2019;1:00;0;0;0
streda;25.12.2019;2:00;0;0;0
streda;25.12.2019;3:00;0;0;0
streda;25.12.2019;4:00;0;0;0
streda;25.12.2019;5:00;0;0;0
streda;25.12.2019;6:00;2;2;0
streda;25.12.2019;7:00;0;0;0
streda;25.12.2019;8:00;1;1;0
streda;25.12.2019;9:00;3;3;0
streda;25.12.2019;10:00;7;4;3
streda;25.12.2019;11:00;12;8;4
streda;25.12.2019;12:00;17;8;9
streda;25.12.2019;13:00;14;8;6
streda;25.12.2019;14:00;24;14;10
streda;25.12.2019;15:00;12;3;9
streda;25.12.2019;16:00;9;3;6
streda;25.12.2019;17:00;3;1;2
streda;25.12.2019;18:00;2;1;1
streda;25.12.2019;19:00;2;0;2
streda;25.12.2019;20:00;2;1;1
streda;25.12.2019;21:00;0;0;0
streda;25.12.2019;22:00;0;0;0
streda;25.12.2019;23:00;0;0;0
štvrtok;26.12.2019;0:00;0;0;0
štvrtok;26.12.2019;1:00;0;0;0
štvrtok;26.12.2019;2:00;0;0;0
štvrtok;26.12.2019;3:00;0;0;0
štvrtok;26.12.2019;4:00;0;0;0
štvrtok;26.12.2019;5:00;0;0;0
štvrtok;26.12.2019;6:00;1;1;0
štvrtok;26.12.2019;7:00;6;2;4
štvrtok;26.12.2019;8:00;3;2;1
štvrtok;26.12.2019;9:00;11;7;4
štvrtok;26.12.2019;10:00;24;15;9
štvrtok;26.12.2019;11:00;36;20;16
štvrtok;26.12.2019;12:00;36;20;16
štvrtok;26.12.2019;13:00;41;28;13
štvrtok;26.12.2019;14:00;25;13;12
štvrtok;26.12.2019;15:00;35;21;14
štvrtok;26.12.2019;16:00;8;4;4
štvrtok;26.12.2019;17:00;5;2;3
štvrtok;26.12.2019;18:00;1;1;0
štvrtok;26.12.2019;19:00;2;0;2
štvrtok;26.12.2019;20:00;2;2;0
štvrtok;26.12.2019;21:00;2;2;0
štvrtok;26.12.2019;22:00;0;0;0
štvrtok;26.12.2019;23:00;2;1;1
piatok;27.12.2019;0:00;1;0;1
piatok;27.12.2019;1:00;0;0;0
piatok;27.12.2019;2:00;0;0;0
piatok;27.12.2019;3:00;0;0;0
piatok;27.12.2019;4:00;0;0;0
piatok;27.12.2019;5:00;1;0;1
piatok;27.12.2019;6:00;2;2;0
piatok;27.12.2019;7:00;2;0;2
piatok;27.12.2019;8:00;5;2;3
piatok;27.12.2019;9:00;11;6;5
piatok;27.12.2019;10:00;19;14;5
piatok;27.12.2019;11:00;41;31;10
piatok;27.12.2019;12:00;26;12;14
piatok;27.12.2019;13:00;30;14;16
piatok;27.12.2019;14:00;40;17;23
piatok;27.12.2019;15:00;27;13;14
piatok;27.12.2019;16:00;15;8;7
piatok;27.12.2019;17:00;11;3;8
piatok;27.12.2019;18:00;10;5;5
piatok;27.12.2019;19:00;13;2;11
piatok;27.12.2019;20:00;9;3;6
piatok;27.12.2019;21:00;3;3;0
piatok;27.12.2019;22:00;0;0;0
piatok;27.12.2019;23:00;3;3;0
sobota;28.12.2019;0:00;0;0;0
sobota;28.12.2019;1:00;0;0;0
sobota;28.12.2019;2:00;0;0;0
sobota;28.12.2019;3:00;0;0;0
sobota;28.12.2019;4:00;0;0;0
sobota;28.12.2019;5:00;0;0;0
sobota;28.12.2019;6:00;0;0;0
sobota;28.12.2019;7:00;2;1;1
sobota;28.12.2019;8:00;5;3;2
sobota;28.12.2019;9:00;9;3;6
sobota;28.12.2019;10:00;19;12;7
sobota;28.12.2019;11:00;24;17;7
sobota;28.12.2019;12:00;19;13;6
sobota;28.12.2019;13:00;15;5;10
sobota;28.12.2019;14:00;12;5;7
sobota;28.12.2019;15:00;11;6;5
sobota;28.12.2019;16:00;6;2;4
sobota;28.12.2019;17:00;3;1;2
sobota;28.12.2019;18:00;1;1;0
sobota;28.12.2019;19:00;2;1;1
sobota;28.12.2019;20:00;0;0;0
sobota;28.12.2019;21:00;0;0;0
sobota;28.12.2019;22:00;1;1;0
sobota;28.12.2019;23:00;1;1;0
nedeľa;29.12.2019;0:00;1;0;1
nedeľa;29.12.2019;1:00;0;0;0
nedeľa;29.12.2019;2:00;0;0;0
nedeľa;29.12.2019;3:00;0;0;0
nedeľa;29.12.2019;4:00;2;0;2
nedeľa;29.12.2019;5:00;0;0;0
nedeľa;29.12.2019;6:00;1;1;0
nedeľa;29.12.2019;7:00;0;0;0
nedeľa;29.12.2019;8:00;1;0;1
nedeľa;29.12.2019;9:00;11;5;6
nedeľa;29.12.2019;10:00;14;13;1
nedeľa;29.12.2019;11:00;17;12;5
nedeľa;29.12.2019;12:00;18;7;11
nedeľa;29.12.2019;13:00;10;4;6
nedeľa;29.12.2019;14:00;10;4;6
nedeľa;29.12.2019;15:00;15;9;6
nedeľa;29.12.2019;16:00;9;4;5
nedeľa;29.12.2019;17:00;3;2;1
nedeľa;29.12.2019;18:00;7;4;3
nedeľa;29.12.2019;19:00;1;0;1
nedeľa;29.12.2019;20:00;0;0;0
nedeľa;29.12.2019;21:00;4;1;3
nedeľa;29.12.2019;22:00;0;0;0
nedeľa;29.12.2019;23:00;1;1;0
pondelok;30.12.2019;0:00;1;0;1
pondelok;30.12.2019;1:00;0;0;0
pondelok;30.12.2019;2:00;0;0;0
pondelok;30.12.2019;3:00;0;0;0
pondelok;30.12.2019;4:00;0;0;0
pondelok;30.12.2019;5:00;2;0;2
pondelok;30.12.2019;6:00;2;1;1
pondelok;30.12.2019;7:00;1;0;1
pondelok;30.12.2019;8:00;4;0;4
pondelok;30.12.2019;9:00;7;5;2
pondelok;30.12.2019;10:00;8;3;5
pondelok;30.12.2019;11:00;19;15;4
pondelok;30.12.2019;12:00;21;15;6
pondelok;30.12.2019;13:00;16;7;9
pondelok;30.12.2019;14:00;27;13;14
pondelok;30.12.2019;15:00;27;16;11
pondelok;30.12.2019;16:00;24;11;13
pondelok;30.12.2019;17:00;9;3;6
pondelok;30.12.2019;18:00;9;4;5
pondelok;30.12.2019;19:00;4;1;3
pondelok;30.12.2019;20:00;2;1;1
pondelok;30.12.2019;21:00;4;1;3
pondelok;30.12.2019;22:00;0;0;0
pondelok;30.12.2019;23:00;1;1;0
utorok;31.12.2019;0:00;1;0;1
utorok;31.12.2019;1:00;0;0;0
utorok;31.12.2019;2:00;0;0;0
utorok;31.12.2019;3:00;0;0;0
utorok;31.12.2019;4:00;0;0;0
utorok;31.12.2019;5:00;0;0;0
utorok;31.12.2019;6:00;2;1;1
utorok;31.12.2019;7:00;2;2;0
utorok;31.12.2019;8:00;7;1;6
utorok;31.12.2019;9:00;11;6;5
utorok;31.12.2019;10:00;16;13;3
utorok;31.12.2019;11:00;36;25;11
utorok;31.12.2019;12:00;71;43;28
utorok;31.12.2019;13:00;50;25;25
utorok;31.12.2019;14:00;61;36;25
utorok;31.12.2019;15:00;32;12;20
utorok;31.12.2019;16:00;15;6;9
utorok;31.12.2019;17:00;8;3;5
utorok;31.12.2019;18:00;3;1;2
utorok;31.12.2019;19:00;0;0;0
utorok;31.12.2019;20:00;3;2;1
utorok;31.12.2019;21:00;3;1;2
utorok;31.12.2019;22:00;3;1;2
utorok;31.12.2019;23:00;24;3;21
